,mode,randmode,level_2,#contacts,#contacts(>4),#contacts(<=4),#rfrags,#rfrags(>4),#rfrags(<=4),max_count,mean_count,median_count,95percentile_count,exp
0,junctions,real,0,281674,1560,280114,274680,62,274618,45,1.0254623561963012,1.0,1.0,oI43
1,junctions+hops,real,0,1944292,558547,1385745,919511,54206,865305,2589,2.1144847641844415,1.0,5.0,oI43
2,random_0,random,0,281674,29533,252141,220771,1767,219004,398,1.2758650366216577,1.0,2.0,oI43
3,random_1,random,0,281674,29845,251829,220638,1796,218842,395,1.2766341246748067,1.0,2.0,oI43
4,random_2,random,0,281674,29471,252203,220980,1767,219213,384,1.2746583401212779,1.0,2.0,oI43
5,random_3,random,0,281674,29800,251874,220913,1809,219104,401,1.2750449271885311,1.0,2.0,oI43
6,random_4,random,0,281674,30091,251583,220302,1809,218493,386,1.2785812203248268,1.0,2.0,oI43
7,random_5,random,0,281674,29487,252187,220815,1771,219044,376,1.275610805425356,1.0,2.0,oI43
8,random_6,random,0,281674,29572,252102,220826,1753,219073,394,1.2755472634562959,1.0,2.0,oI43
9,random_7,random,0,281674,29721,251953,220823,1774,219049,374,1.2755645924564016,1.0,2.0,oI43
10,random_8,random,0,281674,29692,251982,220722,1799,218923,365,1.2761482770181496,1.0,2.0,oI43
11,random_9,random,0,281674,29640,252034,220957,1813,219144,371,1.2747910226876722,1.0,2.0,oI43
0,junctions,real,0,1683140,6067,1677073,1546567,636,1545931,78,1.0883071991061493,1.0,2.0,oI7
1,junctions+hops,real,0,9664772,2887713,6777059,4249986,334033,3915953,3497,2.274071491059029,2.0,5.0,oI7
2,random_0,random,0,1683140,134937,1548203,1296719,9762,1286957,639,1.2979990267744979,1.0,2.0,oI7
3,random_1,random,0,1683140,133923,1549217,1297625,9668,1287957,624,1.2970927656295155,1.0,2.0,oI7
4,random_2,random,0,1683140,134147,1548993,1297355,9689,1287666,615,1.2973627110544146,1.0,2.0,oI7
5,random_3,random,0,1683140,134421,1548719,1296754,9675,1287079,600,1.29796399317064,1.0,2.0,oI7
6,random_4,random,0,1683140,135254,1547886,1296402,9806,1286596,654,1.2983164172841448,1.0,2.0,oI7
7,random_5,random,0,1683140,133956,1549184,1296795,9636,1287159,643,1.2979229562112746,1.0,2.0,oI7
8,random_6,random,0,1683140,134903,1548237,1296742,9733,1287009,636,1.2979760044789173,1.0,2.0,oI7
9,random_7,random,0,1683140,134272,1548868,1297419,9608,1287811,600,1.2972987138310754,1.0,2.0,oI7
10,random_8,random,0,1683140,134949,1548191,1297424,9790,1287634,652,1.297293714313902,1.0,2.0,oI7
11,random_9,random,0,1683140,134391,1548749,1297214,9719,1287495,612,1.297503727218485,1.0,2.0,oI7
0,junctions,real,0,108838,2168,106670,105427,60,105367,84,1.0323541407798762,1.0,1.0,oIH120
1,junctions+hops,real,0,561016,174794,386222,277173,14955,262218,4299,2.024064392996432,1.0,5.0,oIH120
2,random_0,random,0,108838,14546,94292,80612,1222,79390,856,1.3501463801915348,1.0,2.0,oIH120
3,random_1,random,0,108838,14665,94173,80526,1243,79283,833,1.3515883068822492,1.0,2.0,oIH120
4,random_2,random,0,108838,14580,94258,80714,1244,79470,827,1.3484401714696335,1.0,2.0,oIH120
5,random_3,random,0,108838,14885,93953,80424,1247,79177,865,1.353302496767134,1.0,2.0,oIH120
6,random_4,random,0,108838,14983,93855,80313,1281,79032,854,1.3551728860831995,1.0,3.0,oIH120
7,random_5,random,0,108838,14826,94012,80419,1246,79173,812,1.3533866374861663,1.0,2.0,oIH120
8,random_6,random,0,108838,14721,94117,80546,1262,79284,803,1.3512527003203139,1.0,2.0,oIH120
9,random_7,random,0,108838,14928,93910,80309,1267,79042,822,1.3552403840167353,1.0,2.0,oIH120
10,random_8,random,0,108838,14643,94195,80586,1238,79348,773,1.3505819869456233,1.0,2.0,oIH120
11,random_9,random,0,108838,14654,94184,80542,1241,79301,827,1.3513198082987758,1.0,2.0,oIH120
0,junctions,real,0,755170,1007,754163,723059,135,722924,34,1.0444099305865773,1.0,1.0,oIH50
1,junctions+hops,real,0,3568948,977843,2591105,1746086,110033,1636053,904,2.0439703428124387,1.0,5.0,oIH50
2,random_0,random,0,755170,60707,694463,578294,6129,572165,176,1.3058582658647677,1.0,2.0,oIH50
3,random_1,random,0,755170,61065,694105,578178,6108,572070,184,1.306120260542601,1.0,2.0,oIH50
4,random_2,random,0,755170,60593,694577,578302,6062,572240,189,1.3058402011405805,1.0,2.0,oIH50
5,random_3,random,0,755170,60272,694898,578730,5994,572736,218,1.304874466504242,1.0,2.0,oIH50
6,random_4,random,0,755170,60728,694442,577727,6039,571688,208,1.3071398774853866,1.0,2.0,oIH50
7,random_5,random,0,755170,60781,694389,578020,6115,571905,190,1.3064772845230268,1.0,2.0,oIH50
8,random_6,random,0,755170,60524,694646,579003,6040,572963,196,1.3042592180005976,1.0,2.0,oIH50
9,random_7,random,0,755170,61222,693948,577982,6159,571823,205,1.3065631801682405,1.0,2.0,oIH50
10,random_8,random,0,755170,60800,694370,577887,6110,571777,203,1.306777968703224,1.0,2.0,oIH50
11,random_9,random,0,755170,60214,694956,578406,6046,572360,198,1.3056054051998078,1.0,2.0,oIH50
0,junctions,real,0,293052,1465,291587,286336,124,286212,43,1.0234549620026823,1.0,1.0,oIH57
1,junctions+hops,real,0,1731236,510374,1220862,835547,47546,788001,2045,2.071979194467816,1.0,5.0,oIH57
2,random_0,random,0,293052,32773,260279,224326,2637,221689,359,1.3063666271408576,1.0,2.0,oIH57
3,random_1,random,0,293052,32666,260386,224582,2622,221960,335,1.304877505766268,1.0,2.0,oIH57
4,random_2,random,0,293052,32635,260417,224275,2678,221597,377,1.3066636941255156,1.0,2.0,oIH57
5,random_3,random,0,293052,33011,260041,224407,2695,221712,363,1.3058950923990784,1.0,2.0,oIH57
6,random_4,random,0,293052,33435,259617,224262,2727,221535,356,1.306739438692244,1.0,2.0,oIH57
7,random_5,random,0,293052,32752,260300,224517,2652,221865,351,1.3052552813372706,1.0,2.0,oIH57
8,random_6,random,0,293052,32995,260057,224245,2678,221567,329,1.306838502530714,1.0,2.0,oIH57
9,random_7,random,0,293052,32669,260383,224664,2608,222056,361,1.304401239183848,1.0,2.0,oIH57
10,random_8,random,0,293052,32937,260115,224138,2661,221477,336,1.3074623669346563,1.0,2.0,oIH57
11,random_9,random,0,293052,33464,259588,223988,2727,221261,379,1.3083379466757148,1.0,2.0,oIH57
0,junctions,real,0,432938,1812,431126,420012,200,419812,54,1.0307753111815854,1.0,1.0,oIH84
1,junctions+hops,real,0,2851702,1030026,1821676,1268103,92217,1175886,1419,2.2487936705456892,1.0,5.0,oIH84
2,random_0,random,0,432938,56528,376410,320924,5497,315427,225,1.3490359088133015,1.0,3.0,oIH84
3,random_1,random,0,432938,56212,376726,321196,5483,315713,224,1.3478934980510342,1.0,3.0,oIH84
4,random_2,random,0,432938,55994,376944,321153,5419,315734,238,1.3480739709733367,1.0,3.0,oIH84
5,random_3,random,0,432938,56194,376744,321044,5419,315625,209,1.3485316654414972,1.0,3.0,oIH84
6,random_4,random,0,432938,56610,376328,320809,5507,315302,205,1.3495194960241141,1.0,3.0,oIH84
7,random_5,random,0,432938,56079,376859,321207,5446,315761,225,1.3478473383207714,1.0,3.0,oIH84
8,random_6,random,0,432938,56192,376746,321103,5426,315677,218,1.348283883987381,1.0,3.0,oIH84
9,random_7,random,0,432938,56366,376572,320613,5466,315147,229,1.3503444963242288,1.0,3.0,oIH84
10,random_8,random,0,432938,56494,376444,321088,5491,315597,220,1.3483468706398245,1.0,3.0,oIH84
11,random_9,random,0,432938,56798,376140,320502,5538,314964,211,1.350812163418637,1.0,3.0,oIH84
0,junctions,real,0,1487434,4398,1483036,1369802,578,1369224,44,1.0858751848807346,1.0,2.0,oN1
1,junctions+hops,real,0,11631552,4212633,7418919,4702030,580041,4121989,4096,2.473729857104272,2.0,7.0,oN1
2,random_0,random,0,1487434,27029,1460405,1218852,4065,1214787,517,1.2203565322122785,1.0,2.0,oN1
3,random_1,random,0,1487434,26632,1460802,1219088,3994,1215094,537,1.220120286640505,1.0,2.0,oN1
4,random_2,random,0,1487434,27129,1460305,1219328,4057,1215271,523,1.21988013069494,1.0,2.0,oN1
5,random_3,random,0,1487434,26955,1460479,1219835,4034,1215801,539,1.2193731119372702,1.0,2.0,oN1
6,random_4,random,0,1487434,27077,1460357,1218806,4058,1214748,524,1.2204025907322413,1.0,2.0,oN1
7,random_5,random,0,1487434,27023,1460411,1219010,4035,1214975,549,1.2201983576836941,1.0,2.0,oN1
8,random_6,random,0,1487434,26905,1460529,1219094,4037,1215057,515,1.2201142815894426,1.0,2.0,oN1
9,random_7,random,0,1487434,27322,1460112,1219407,4083,1215324,528,1.2198011000428897,1.0,2.0,oN1
10,random_8,random,0,1487434,27102,1460332,1219116,4049,1215067,515,1.22009226357459,1.0,2.0,oN1
11,random_9,random,0,1487434,27119,1460315,1218862,4068,1214794,519,1.2203465199505767,1.0,2.0,oN1
0,junctions,real,0,785206,3063,782143,749310,345,748965,95,1.0479054063071358,1.0,1.0,oN10
1,junctions+hops,real,0,5150374,1569424,3580950,2391799,195913,2195886,2632,2.153347333952393,1.0,6.0,oN10
2,random_0,random,0,785206,33351,751855,633497,4426,629071,414,1.2394786399935596,1.0,2.0,oN10
3,random_1,random,0,785206,32980,752226,633703,4386,629317,405,1.2390757184359233,1.0,2.0,oN10
4,random_2,random,0,785206,33150,752056,633274,4373,628901,388,1.2399151078364183,1.0,2.0,oN10
5,random_3,random,0,785206,33513,751693,633108,4456,628652,429,1.2402402117806124,1.0,2.0,oN10
6,random_4,random,0,785206,32889,752317,633565,4334,629231,390,1.2393456077908345,1.0,2.0,oN10
7,random_5,random,0,785206,33663,751543,633277,4444,628833,394,1.2399092340318691,1.0,2.0,oN10
8,random_6,random,0,785206,33377,751829,633159,4454,628705,379,1.2401403123070192,1.0,2.0,oN10
9,random_7,random,0,785206,32613,752593,634095,4312,629783,422,1.2383097169982415,1.0,2.0,oN10
10,random_8,random,0,785206,33032,752174,633800,4381,629419,387,1.2388860839381508,1.0,2.0,oN10
11,random_9,random,0,785206,33542,751664,633175,4494,628681,393,1.2401089746120741,1.0,2.0,oN10
0,junctions,real,0,709480,2710,706770,682131,128,682003,60,1.040093471781813,1.0,1.0,oN12
1,junctions+hops,real,0,4499074,1219682,3279392,2082290,151328,1930962,1925,2.160637567293701,1.0,5.0,oN12
2,random_0,random,0,709480,40850,668630,571012,2823,568189,305,1.2424957794231994,1.0,2.0,oN12
3,random_1,random,0,709480,40684,668796,570962,2842,568120,308,1.2426045866449957,1.0,2.0,oN12
4,random_2,random,0,709480,40820,668660,570621,2851,567770,326,1.243347160374399,1.0,2.0,oN12
5,random_3,random,0,709480,40327,669153,571177,2760,568417,300,1.242136850748542,1.0,2.0,oN12
6,random_4,random,0,709480,40626,668854,571154,2866,568288,312,1.2421868707914152,1.0,2.0,oN12
7,random_5,random,0,709480,40901,668579,570739,2836,567903,340,1.2430900989769404,1.0,2.0,oN12
8,random_6,random,0,709480,40375,669105,571391,2794,568597,315,1.241671639910324,1.0,2.0,oN12
9,random_7,random,0,709480,40606,668874,571519,2807,568712,325,1.2413935494707962,1.0,2.0,oN12
10,random_8,random,0,709480,40478,669002,571245,2810,568435,323,1.2419889889627043,1.0,2.0,oN12
11,random_9,random,0,709480,39716,669764,571679,2740,568939,324,1.241046111541617,1.0,2.0,oN12
0,junctions,real,0,75300,2139,73161,72229,117,72112,129,1.0425175483531546,1.0,1.0,oN134
1,junctions+hops,real,0,409806,132120,277686,211611,11402,200209,3636,1.9366006493046202,1.0,5.0,oN134
2,random_0,random,0,75300,10101,65199,56024,882,55142,693,1.3440668285020705,1.0,3.0,oN134
3,random_1,random,0,75300,9976,65324,56264,894,55370,666,1.3383335703113892,1.0,3.0,oN134
4,random_2,random,0,75300,10129,65171,56197,872,55325,722,1.339929177714113,1.0,2.0,oN134
5,random_3,random,0,75300,9935,65365,56157,864,55293,676,1.3408835942090924,1.0,3.0,oN134
6,random_4,random,0,75300,9976,65324,56279,910,55369,677,1.3379768652605768,1.0,3.0,oN134
7,random_5,random,0,75300,10163,65137,56092,887,55205,690,1.3424374242316195,1.0,3.0,oN134
8,random_6,random,0,75300,9679,65621,56382,834,55548,651,1.3355326167925934,1.0,2.0,oN134
9,random_7,random,0,75300,9652,65648,56447,837,55610,671,1.3339947207114637,1.0,3.0,oN134
10,random_8,random,0,75300,10384,64916,56079,918,55161,657,1.3427486224790028,1.0,3.0,oN134
11,random_9,random,0,75300,10022,65278,56227,872,55355,677,1.3392142564959895,1.0,2.0,oN134
0,junctions,real,0,685210,3488,681722,658285,315,657970,157,1.0409017370895586,1.0,1.0,oN15
1,junctions+hops,real,0,4703658,1763411,2940247,1941823,165337,1776486,4697,2.4222897761536455,1.0,6.0,oN15
2,random_0,random,0,685210,90765,594445,504351,6032,498319,692,1.358597484688243,1.0,2.0,oN15
3,random_1,random,0,685210,90448,594762,504730,6034,498696,700,1.3575773185663622,1.0,2.0,oN15
4,random_2,random,0,685210,90752,594458,503783,6027,497756,698,1.3601292620036802,1.0,2.0,oN15
5,random_3,random,0,685210,90458,594752,503740,5975,497765,689,1.3602453646722517,1.0,2.0,oN15
6,random_4,random,0,685210,90262,594948,503893,5941,497952,689,1.3598323453590346,1.0,2.0,oN15
7,random_5,random,0,685210,90899,594311,503550,6050,497500,689,1.3607586138417238,1.0,2.0,oN15
8,random_6,random,0,685210,90780,594430,503103,6042,497061,658,1.361967628895077,1.0,2.0,oN15
9,random_7,random,0,685210,91020,594190,503505,5987,497518,667,1.3608802295905702,1.0,2.0,oN15
10,random_8,random,0,685210,91044,594166,503491,6027,497464,683,1.3609180700350154,1.0,2.0,oN15
11,random_9,random,0,685210,91442,593768,503202,6066,497136,666,1.36169967527951,1.0,2.0,oN15
0,junctions,real,0,48766,996,47770,47309,55,47254,56,1.0307975226701052,1.0,1.0,oN152
1,junctions+hops,real,0,243946,73318,170628,126373,5422,120951,1913,1.9303648722432798,1.0,4.0,oN152
2,random_0,random,0,48766,7429,41337,35924,644,35280,393,1.3574768956686338,1.0,2.0,oN152
3,random_1,random,0,48766,7664,41102,35928,669,35259,393,1.357325762636384,1.0,2.0,oN152
4,random_2,random,0,48766,7535,41231,36026,660,35366,374,1.3536334869261089,1.0,2.0,oN152
5,random_3,random,0,48766,7615,41151,36143,667,35476,381,1.3492515839858341,1.0,2.0,oN152
6,random_4,random,0,48766,7454,41312,35918,626,35292,392,1.3577036583328692,1.0,2.0,oN152
7,random_5,random,0,48766,7824,40942,35814,693,35121,389,1.361646283576255,1.0,2.0,oN152
8,random_6,random,0,48766,7822,40944,35861,694,35167,371,1.3598616881849364,1.0,2.0,oN152
9,random_7,random,0,48766,7823,40943,35744,678,35066,369,1.3643128916741272,1.0,2.0,oN152
10,random_8,random,0,48766,7789,40977,35733,681,35052,394,1.3647328799708953,1.0,2.0,oN152
11,random_9,random,0,48766,7511,41255,36200,655,35545,376,1.3471270718232045,1.0,2.0,oN152
0,junctions,real,0,51036,1294,49742,49135,67,49068,74,1.0386893253281775,1.0,1.0,oN153
1,junctions+hops,real,0,317738,130642,187096,137833,9033,128800,2960,2.305238948582705,1.0,5.0,oN153
2,random_0,random,0,51036,10954,40082,34523,1012,33511,512,1.4783188019581148,1.0,3.0,oN153
3,random_1,random,0,51036,10484,40552,34838,952,33886,503,1.4649520638383375,1.0,3.0,oN153
4,random_2,random,0,51036,10667,40369,34838,976,33862,482,1.4649520638383375,1.0,3.0,oN153
5,random_3,random,0,51036,10671,40365,34667,999,33668,461,1.4721781521331525,1.0,3.0,oN153
6,random_4,random,0,51036,10693,40343,34648,981,33667,461,1.4729854537058416,1.0,3.0,oN153
7,random_5,random,0,51036,10273,40763,34989,926,34063,471,1.4586298550973162,1.0,3.0,oN153
8,random_6,random,0,51036,10483,40553,34782,956,33826,466,1.4673106779368639,1.0,3.0,oN153
9,random_7,random,0,51036,10632,40404,34924,974,33950,467,1.4613446340625358,1.0,3.0,oN153
10,random_8,random,0,51036,10807,40229,34699,1011,33688,496,1.4708204847401942,1.0,3.0,oN153
11,random_9,random,0,51036,10574,40462,34743,960,33783,510,1.4689577756670409,1.0,3.0,oN153
0,junctions,real,0,40282,896,39386,39023,48,38975,53,1.032263024370243,1.0,1.0,oN155
1,junctions+hops,real,0,263794,82250,181544,127636,9372,118264,675,2.0667679964900185,1.0,6.0,oN155
2,random_0,random,0,40282,2427,37855,32115,310,31805,119,1.2543048419741554,1.0,2.0,oN155
3,random_1,random,0,40282,2368,37914,32213,298,31915,99,1.2504889330394562,1.0,2.0,oN155
4,random_2,random,0,40282,2134,38148,32319,275,32044,107,1.246387573872954,1.0,2.0,oN155
5,random_3,random,0,40282,2373,37909,32120,299,31821,104,1.2541095890410958,1.0,2.0,oN155
6,random_4,random,0,40282,2295,37987,32034,285,31749,121,1.2574764312917526,1.0,2.0,oN155
7,random_5,random,0,40282,2264,38018,32125,285,31840,106,1.2539143968871596,1.0,2.0,oN155
8,random_6,random,0,40282,2286,37996,32061,299,31762,107,1.256417454227878,1.0,2.0,oN155
9,random_7,random,0,40282,2386,37896,32183,311,31872,113,1.2516546002547928,1.0,2.0,oN155
10,random_8,random,0,40282,2173,38109,32091,271,31820,110,1.255242902994609,1.0,2.0,oN155
11,random_9,random,0,40282,2324,37958,32168,302,31866,107,1.2522382491917434,1.0,2.0,oN155
0,junctions,real,0,46324,1956,44368,43775,102,43673,70,1.058229583095374,1.0,1.0,oN159
1,junctions+hops,real,0,249700,84070,165630,122190,6578,115612,3045,2.0435387511252965,1.0,5.0,oN159
2,random_0,random,0,46324,7445,38879,33552,607,32945,563,1.3806628516928947,1.0,3.0,oN159
3,random_1,random,0,46324,7303,39021,33645,593,33052,567,1.3768464853618665,1.0,3.0,oN159
4,random_2,random,0,46324,7388,38936,33567,615,32952,565,1.3800458783924687,1.0,3.0,oN159
5,random_3,random,0,46324,7282,39042,33626,584,33042,565,1.3776244572652114,1.0,3.0,oN159
6,random_4,random,0,46324,7506,38818,33476,613,32863,583,1.3837973473533278,1.0,3.0,oN159
7,random_5,random,0,46324,7503,38821,33433,614,32819,606,1.38557712439805,1.0,3.0,oN159
8,random_6,random,0,46324,7414,38910,33370,595,32775,563,1.388192987713515,1.0,3.0,oN159
9,random_7,random,0,46324,7240,39084,33585,590,32995,604,1.3793062379038261,1.0,3.0,oN159
10,random_8,random,0,46324,7250,39074,33663,598,33065,581,1.3761102694352851,1.0,3.0,oN159
11,random_9,random,0,46324,7263,39061,33690,594,33096,580,1.3750074205995844,1.0,2.0,oN159
0,junctions,real,0,34794,1275,33519,33197,62,33135,68,1.0481067566346356,1.0,1.0,oN168
1,junctions+hops,real,0,149736,26656,123080,93794,2474,91320,1245,1.5964347399620444,1.0,3.0,oN168
2,random_0,random,0,34794,2799,31995,28479,230,28249,288,1.221742336458443,1.0,2.0,oN168
3,random_1,random,0,34794,2856,31938,28505,237,28268,295,1.2206279600070162,1.0,2.0,oN168
4,random_2,random,0,34794,2854,31940,28440,241,28199,284,1.2234177215189874,1.0,2.0,oN168
5,random_3,random,0,34794,2733,32061,28565,209,28356,291,1.2180640644144933,1.0,2.0,oN168
6,random_4,random,0,34794,2804,31990,28343,219,28124,295,1.227604699573087,1.0,2.0,oN168
7,random_5,random,0,34794,2784,32010,28370,217,28153,345,1.2264363764540007,1.0,2.0,oN168
8,random_6,random,0,34794,2776,32018,28389,217,28172,315,1.2256155553207229,1.0,2.0,oN168
9,random_7,random,0,34794,2769,32025,28425,240,28185,289,1.2240633245382586,1.0,2.0,oN168
10,random_8,random,0,34794,2895,31899,28376,226,28150,288,1.2261770510290386,1.0,2.0,oN168
11,random_9,random,0,34794,2800,31994,28526,227,28299,291,1.2197293696978195,1.0,2.0,oN168
0,junctions,real,0,1227456,5711,1221745,1148381,453,1147928,125,1.068857809385561,1.0,2.0,oN17
1,junctions+hops,real,0,7702438,2748363,4954075,3201814,287680,2914134,3938,2.405648173191822,1.0,6.0,oN17
2,random_0,random,0,1227456,132472,1094984,916425,9017,907408,624,1.3393960225877732,1.0,2.0,oN17
3,random_1,random,0,1227456,133481,1093975,915288,9125,906163,608,1.3410598631250492,1.0,2.0,oN17
4,random_2,random,0,1227456,133235,1094221,914678,9056,905622,647,1.3419542177684387,1.0,2.0,oN17
5,random_3,random,0,1227456,132870,1094586,915758,9058,906700,605,1.3403715828854348,1.0,2.0,oN17
6,random_4,random,0,1227456,133137,1094319,915022,9023,905999,646,1.3414497137773738,1.0,2.0,oN17
7,random_5,random,0,1227456,133035,1094421,915099,9064,906035,623,1.3413368389649645,1.0,2.0,oN17
8,random_6,random,0,1227456,131673,1095783,915731,8932,906799,652,1.3404111032606738,1.0,2.0,oN17
9,random_7,random,0,1227456,133371,1094085,914743,9066,905677,625,1.341858860904101,1.0,2.0,oN17
10,random_8,random,0,1227456,132642,1094814,915520,9049,906471,626,1.3407200279622509,1.0,2.0,oN17
11,random_9,random,0,1227456,132784,1094672,915021,9033,905988,650,1.341451179808988,1.0,2.0,oN17
0,junctions,real,0,26588,2352,24236,23888,69,23819,95,1.113027461486939,1.0,1.0,oN180
1,junctions+hops,real,0,128520,42256,86264,60742,3677,57065,1820,2.1158341839254553,1.0,5.0,oN180
2,random_0,random,0,26588,3951,22637,19056,315,18741,384,1.3952560873215785,1.0,3.0,oN180
3,random_1,random,0,26588,4059,22529,19015,339,18676,367,1.3982645280042072,1.0,3.0,oN180
4,random_2,random,0,26588,3952,22636,19098,322,18776,393,1.3921876636296995,1.0,3.0,oN180
5,random_3,random,0,26588,3867,22721,19082,309,18773,370,1.393354994235405,1.0,3.0,oN180
6,random_4,random,0,26588,3902,22686,19081,304,18777,415,1.3934280173995073,1.0,3.0,oN180
7,random_5,random,0,26588,4014,22574,19142,330,18812,376,1.38898756660746,1.0,3.0,oN180
8,random_6,random,0,26588,3707,22881,19204,295,18909,383,1.3845032284940637,1.0,3.0,oN180
9,random_7,random,0,26588,3949,22639,19093,321,18772,377,1.3925522442780076,1.0,3.0,oN180
10,random_8,random,0,26588,3936,22652,19145,320,18825,372,1.3887699138156178,1.0,3.0,oN180
11,random_9,random,0,26588,3970,22618,19041,322,18719,381,1.3963552334436216,1.0,3.0,oN180
0,junctions,real,0,22558,1198,21360,21022,66,20956,68,1.073066311483208,1.0,1.0,oN182
1,junctions+hops,real,0,160354,64363,95991,69664,4296,65368,2056,2.3018201653651813,1.0,5.0,oN182
2,random_0,random,0,22558,4345,18213,15768,378,15390,316,1.430618975139523,1.0,3.0,oN182
3,random_1,random,0,22558,4422,18136,15773,388,15385,296,1.4301654726431243,1.0,3.0,oN182
4,random_2,random,0,22558,4304,18254,15794,363,15431,296,1.4282638976826643,1.0,3.0,oN182
5,random_3,random,0,22558,4423,18135,15706,399,15307,309,1.436266395008277,1.0,3.0,oN182
6,random_4,random,0,22558,4390,18168,15697,384,15313,314,1.4370898897878575,1.0,3.0,oN182
7,random_5,random,0,22558,4336,18222,15836,374,15462,305,1.4244758777469058,1.0,3.0,oN182
8,random_6,random,0,22558,4442,18116,15724,396,15328,285,1.4346222335283643,1.0,3.0,oN182
9,random_7,random,0,22558,4531,18027,15702,406,15296,286,1.4366322761431665,1.0,3.0,oN182
10,random_8,random,0,22558,4239,18319,15810,371,15439,294,1.426818469323213,1.0,3.0,oN182
11,random_9,random,0,22558,4413,18145,15673,381,15292,315,1.439290499585274,1.0,3.0,oN182
0,junctions,real,0,17206,931,16275,16027,58,15969,51,1.0735633618269171,1.0,1.0,oN189
1,junctions+hops,real,0,112124,51608,60516,44529,3650,40879,2221,2.517999505939949,1.0,6.0,oN189
2,random_0,random,0,17206,3668,13538,11362,320,11042,340,1.51434606583348,1.0,3.0,oN189
3,random_1,random,0,17206,3708,13498,11357,324,11033,359,1.5150127674561944,1.0,3.0,oN189
4,random_2,random,0,17206,3785,13421,11270,336,10934,357,1.5267080745341615,1.0,3.0,oN189
5,random_3,random,0,17206,3593,13613,11389,307,11082,363,1.5107559926244623,1.0,3.0,oN189
6,random_4,random,0,17206,3633,13573,11345,314,11031,361,1.5166152490083737,1.0,3.0,oN189
7,random_5,random,0,17206,3735,13471,11393,340,11053,349,1.510225577108751,1.0,3.0,oN189
8,random_6,random,0,17206,3766,13440,11349,337,11012,352,1.5160807119570006,1.0,3.0,oN189
9,random_7,random,0,17206,3809,13397,11300,339,10961,349,1.5226548672566371,1.0,3.0,oN189
10,random_8,random,0,17206,3527,13679,11491,311,11180,316,1.4973457488469237,1.0,3.0,oN189
11,random_9,random,0,17206,3664,13542,11327,324,11003,375,1.5190253376887084,1.0,3.0,oN189
0,junctions,real,0,1568,40,1528,1500,3,1497,18,1.0453333333333332,1.0,1.0,oN218
1,junctions+hops,real,0,6092,223,5869,5075,22,5053,41,1.2003940886699507,1.0,2.0,oN218
2,random_0,random,0,1568,28,1540,1461,3,1458,11,1.0732375085557837,1.0,2.0,oN218
3,random_1,random,0,1568,31,1537,1447,3,1444,14,1.0836212854181064,1.0,2.0,oN218
4,random_2,random,0,1568,35,1533,1452,3,1449,14,1.0798898071625345,1.0,2.0,oN218
5,random_3,random,0,1568,32,1536,1471,3,1468,13,1.0659415363698164,1.0,1.0,oN218
6,random_4,random,0,1568,37,1531,1461,5,1456,11,1.0732375085557837,1.0,1.0,oN218
7,random_5,random,0,1568,29,1539,1461,3,1458,12,1.0732375085557837,1.0,2.0,oN218
8,random_6,random,0,1568,34,1534,1458,4,1454,11,1.075445816186557,1.0,2.0,oN218
9,random_7,random,0,1568,27,1541,1487,3,1484,12,1.054472091459314,1.0,1.0,oN218
10,random_8,random,0,1568,22,1546,1465,2,1463,14,1.070307167235495,1.0,2.0,oN218
11,random_9,random,0,1568,28,1540,1465,3,1462,12,1.070307167235495,1.0,1.0,oN218
0,junctions,real,0,494628,1546,493082,479764,73,479691,60,1.0309818994338884,1.0,1.0,oN25
1,junctions+hops,real,0,2844566,823558,2021008,1348408,78784,1269624,3742,2.1095736601978037,1.0,5.0,oN25
2,random_0,random,0,494628,56103,438525,376733,3101,373632,654,1.3129404644668772,1.0,2.0,oN25
3,random_1,random,0,494628,55254,439374,377420,3052,374368,646,1.3105505802554183,1.0,2.0,oN25
4,random_2,random,0,494628,55858,438770,377019,3025,373994,660,1.3119444908612032,1.0,2.0,oN25
5,random_3,random,0,494628,55897,438731,377132,3071,374061,667,1.3115513931461664,1.0,2.0,oN25
6,random_4,random,0,494628,56012,438616,376944,3129,373815,647,1.312205526550363,1.0,2.0,oN25
7,random_5,random,0,494628,55516,439112,377325,3023,374302,680,1.3108805406479824,1.0,2.0,oN25
8,random_6,random,0,494628,55935,438693,376823,3047,373776,613,1.3126268831785746,1.0,2.0,oN25
9,random_7,random,0,494628,55867,438761,377330,3115,374215,689,1.3108631701693478,1.0,2.0,oN25
10,random_8,random,0,494628,55567,439061,377220,3064,374156,660,1.3112454270717353,1.0,2.0,oN25
11,random_9,random,0,494628,55541,439087,377179,3020,374159,629,1.311387961683975,1.0,2.0,oN25
0,junctions,real,0,380612,1149,379463,370795,65,370730,36,1.0264755457867556,1.0,1.0,oN30
1,junctions+hops,real,0,2648290,704060,1944230,1283544,79067,1204477,1557,2.063263900575282,1.0,5.0,oN30
2,random_0,random,0,380612,27376,353236,308885,1824,307061,212,1.2322126357705943,1.0,2.0,oN30
3,random_1,random,0,380612,27326,353286,308775,1815,306960,228,1.2326516071573153,1.0,2.0,oN30
4,random_2,random,0,380612,27358,353254,308879,1847,307032,224,1.2322365716024721,1.0,2.0,oN30
5,random_3,random,0,380612,27174,353438,308893,1831,307062,210,1.232180722774553,1.0,2.0,oN30
6,random_4,random,0,380612,27608,353004,308239,1860,306379,233,1.2347950778454382,1.0,2.0,oN30
7,random_5,random,0,380612,27629,352983,308384,1872,306512,218,1.234214485835841,1.0,2.0,oN30
8,random_6,random,0,380612,27515,353097,308750,1857,306893,234,1.2327514170040486,1.0,2.0,oN30
9,random_7,random,0,380612,27739,352873,308369,1883,306486,225,1.2342745217580238,1.0,2.0,oN30
10,random_8,random,0,380612,27360,353252,308413,1809,306604,217,1.2340984329454336,1.0,2.0,oN30
11,random_9,random,0,380612,27620,352992,308739,1879,306860,226,1.2327953384574026,1.0,2.0,oN30
0,junctions,real,0,421972,1657,420315,410814,77,410737,48,1.0271607101997497,1.0,1.0,oN32
1,junctions+hops,real,0,2321012,563144,1757868,1180474,57101,1123373,1876,1.9661695217344897,1.0,4.0,oN32
2,random_0,random,0,421972,37640,384332,333146,2256,330890,361,1.266627844848805,1.0,2.0,oN32
3,random_1,random,0,421972,37525,384447,333124,2214,330910,340,1.2667114948187461,1.0,2.0,oN32
4,random_2,random,0,421972,38026,383946,332654,2282,330372,337,1.2685012054567208,1.0,2.0,oN32
5,random_3,random,0,421972,38384,383588,332790,2298,330492,347,1.2679828119835332,1.0,2.0,oN32
6,random_4,random,0,421972,37890,384082,332923,2264,330659,337,1.2674762632800978,1.0,2.0,oN32
7,random_5,random,0,421972,37509,384463,332809,2215,330594,332,1.2679104230955294,1.0,2.0,oN32
8,random_6,random,0,421972,37989,383983,332976,2282,330694,335,1.2672745182836,1.0,2.0,oN32
9,random_7,random,0,421972,38114,383858,332846,2252,330594,344,1.2677694789782663,1.0,2.0,oN32
10,random_8,random,0,421972,37499,384473,333173,2250,330923,387,1.2665251986205366,1.0,2.0,oN32
11,random_9,random,0,421972,37949,384023,332773,2253,330520,340,1.2680475879954203,1.0,2.0,oN32
0,junctions,real,0,896496,5599,890897,852163,520,851643,135,1.0520240845941446,1.0,1.0,oN4
1,junctions+hops,real,0,5726322,1983142,3743180,2412622,245734,2166888,2806,2.373484947082469,2.0,6.0,oN4
2,random_0,random,0,896496,51273,845223,698683,5357,693326,403,1.283122675090134,1.0,2.0,oN4
3,random_1,random,0,896496,51559,844937,697953,5407,692546,487,1.2844647132400033,1.0,2.0,oN4
4,random_2,random,0,896496,51229,845267,698086,5356,692730,455,1.2842199958171343,1.0,2.0,oN4
5,random_3,random,0,896496,50823,845673,698999,5273,693726,431,1.282542607357092,1.0,2.0,oN4
6,random_4,random,0,896496,51476,845020,698633,5388,693245,451,1.2832145060425144,1.0,2.0,oN4
7,random_5,random,0,896496,50598,845898,699009,5272,693737,434,1.2825242593443003,1.0,2.0,oN4
8,random_6,random,0,896496,50583,845913,698763,5290,693473,450,1.2829757729015416,1.0,2.0,oN4
9,random_7,random,0,896496,51874,844622,697871,5434,692437,441,1.2846156381336953,1.0,2.0,oN4
10,random_8,random,0,896496,51608,844888,698753,5421,693332,465,1.2829941338355613,1.0,2.0,oN4
11,random_9,random,0,896496,51338,845158,698443,5404,693039,446,1.2835635835708856,1.0,2.0,oN4
0,junctions,real,0,316014,100,315914,309501,18,309483,8,1.0210435507478166,1.0,1.0,oN40
1,junctions+hops,real,0,1804122,420785,1383337,925021,41271,883750,990,1.950357883766963,1.0,4.0,oN40
2,random_0,random,0,316014,28779,287235,251338,1892,249446,165,1.2573267870357845,1.0,2.0,oN40
3,random_1,random,0,316014,28842,287172,250902,1889,249013,173,1.2595116818518783,1.0,2.0,oN40
4,random_2,random,0,316014,28858,287156,251278,1861,249417,170,1.2576270107211933,1.0,2.0,oN40
5,random_3,random,0,316014,28789,287225,251440,1881,249559,189,1.2568167356029272,1.0,2.0,oN40
6,random_4,random,0,316014,28761,287253,251416,1811,249605,184,1.2569367104718872,1.0,2.0,oN40
7,random_5,random,0,316014,28743,287271,251046,1863,249183,193,1.2587892258789226,1.0,2.0,oN40
8,random_6,random,0,316014,28828,287186,250856,1843,249013,208,1.2597426411965431,1.0,2.0,oN40
9,random_7,random,0,316014,28662,287352,251651,1846,249805,186,1.2557629415341087,1.0,2.0,oN40
10,random_8,random,0,316014,28477,287537,251384,1815,249569,175,1.2570967125990518,1.0,2.0,oN40
11,random_9,random,0,316014,28747,287267,251099,1874,249225,174,1.2585235305596598,1.0,2.0,oN40
0,junctions,real,0,807426,1681,805745,770755,198,770557,75,1.0475780241451564,1.0,1.0,oN41
1,junctions+hops,real,0,3907170,1287361,2619809,1761474,142287,1619187,904,2.218125274627954,1.0,6.0,oN41
2,random_0,random,0,807426,76943,730483,596410,8375,588035,184,1.353810298284737,1.0,3.0,oN41
3,random_1,random,0,807426,77942,729484,596541,8508,588033,196,1.353513002459177,1.0,3.0,oN41
4,random_2,random,0,807426,78158,729268,595777,8520,587257,169,1.3552486920441709,1.0,3.0,oN41
5,random_3,random,0,807426,76879,730547,596348,8397,587951,186,1.3539510487165212,1.0,3.0,oN41
6,random_4,random,0,807426,77756,729670,596005,8522,587483,183,1.3547302455516312,1.0,3.0,oN41
7,random_5,random,0,807426,77753,729673,595759,8460,587299,198,1.3552896389311786,1.0,3.0,oN41
8,random_6,random,0,807426,78155,729271,594945,8491,586454,190,1.357143937674911,1.0,3.0,oN41
9,random_7,random,0,807426,78073,729353,595313,8457,586856,190,1.3563050025784755,1.0,3.0,oN41
10,random_8,random,0,807426,77101,730325,595455,8372,587083,190,1.3559815603194196,1.0,3.0,oN41
11,random_9,random,0,807426,77433,729993,596249,8436,587813,172,1.354175856060136,1.0,3.0,oN41
0,junctions,real,0,290384,103,290281,284749,17,284732,13,1.019789358347176,1.0,1.0,oN44
1,junctions+hops,real,0,1873834,573328,1300506,891876,44615,847261,2182,2.1010028299898194,1.0,5.0,oN44
2,random_0,random,0,290384,43201,247183,217583,2328,215255,339,1.3345895589269383,1.0,2.0,oN44
3,random_1,random,0,290384,43353,247031,217370,2335,215035,363,1.3358973179371578,1.0,2.0,oN44
4,random_2,random,0,290384,43063,247321,217707,2335,215372,350,1.333829412926548,1.0,2.0,oN44
5,random_3,random,0,290384,43534,246850,217327,2421,214906,327,1.3361616366121098,1.0,2.0,oN44
6,random_4,random,0,290384,43108,247276,217678,2324,215354,338,1.3340071114214573,1.0,2.0,oN44
7,random_5,random,0,290384,43462,246922,217164,2379,214785,325,1.3371645392422318,1.0,2.0,oN44
8,random_6,random,0,290384,42539,247845,218187,2309,215878,351,1.3308950579090413,1.0,2.0,oN44
9,random_7,random,0,290384,43558,246826,217062,2410,214652,369,1.337792888667754,1.0,2.0,oN44
10,random_8,random,0,290384,43318,247066,217429,2349,215080,351,1.3355348182625133,1.0,2.0,oN44
11,random_9,random,0,290384,43670,246714,217051,2375,214676,336,1.337860687119617,1.0,2.0,oN44
0,junctions,real,0,689498,1012,688486,665049,128,664921,25,1.0367627047029617,1.0,1.0,oN47
1,junctions+hops,real,0,3883610,1491575,2392035,1553535,143382,1410153,3001,2.4998535597846203,1.0,6.0,oN47
2,random_0,random,0,689498,95519,593979,487748,7355,480393,540,1.4136357299261093,1.0,3.0,oN47
3,random_1,random,0,689498,94774,594724,487908,7345,480563,520,1.413172155406347,1.0,3.0,oN47
4,random_2,random,0,689498,95764,593734,487588,7406,480182,538,1.4140996086860218,1.0,3.0,oN47
5,random_3,random,0,689498,95126,594372,488699,7330,481369,531,1.4108848186716159,1.0,3.0,oN47
6,random_4,random,0,689498,95459,594039,488577,7359,481218,540,1.411237123319354,1.0,3.0,oN47
7,random_5,random,0,689498,95809,593689,488079,7435,480644,550,1.412677046133925,1.0,3.0,oN47
8,random_6,random,0,689498,95036,594462,488570,7375,481195,542,1.4112573428577277,1.0,3.0,oN47
9,random_7,random,0,689498,95500,593998,487744,7377,480367,515,1.4136473231859337,1.0,3.0,oN47
10,random_8,random,0,689498,94813,594685,488667,7360,481307,529,1.410977209428916,1.0,3.0,oN47
11,random_9,random,0,689498,96131,593367,487469,7520,479949,526,1.4144448159780416,1.0,3.0,oN47
0,junctions,real,0,285190,1345,283845,278302,119,278183,43,1.0247500916270813,1.0,1.0,oN48
1,junctions+hops,real,0,2182320,768221,1414099,968755,85549,883206,1454,2.2527057924862324,1.0,6.0,oN48
2,random_0,random,0,285190,18793,266397,225976,2306,223670,188,1.2620366764612172,1.0,2.0,oN48
3,random_1,random,0,285190,18813,266377,226258,2277,223981,197,1.2604637184099567,1.0,2.0,oN48
4,random_2,random,0,285190,18826,266364,226046,2311,223735,184,1.261645859692275,1.0,2.0,oN48
5,random_3,random,0,285190,18503,266687,226799,2282,224517,206,1.257457043461391,1.0,2.0,oN48
6,random_4,random,0,285190,18818,266372,225760,2331,223429,199,1.26324415308292,1.0,2.0,oN48
7,random_5,random,0,285190,18749,266441,226086,2292,223794,198,1.2614226444804189,1.0,2.0,oN48
8,random_6,random,0,285190,18733,266457,226300,2269,224031,188,1.2602297834732656,1.0,2.0,oN48
9,random_7,random,0,285190,18461,266729,226343,2259,224084,193,1.2599903685998683,1.0,2.0,oN48
10,random_8,random,0,285190,18917,266273,226339,2312,224027,193,1.2600126359133865,1.0,2.0,oN48
11,random_9,random,0,285190,18299,266891,226707,2242,224465,197,1.25796733228352,1.0,2.0,oN48
0,junctions,real,0,925600,5190,920410,881897,438,881459,86,1.0495556737351415,1.0,1.0,oN5
1,junctions+hops,real,0,5830044,1869920,3960124,2584388,178963,2405425,2209,2.255870248584965,1.0,5.0,oN5
2,random_0,random,0,925600,109631,815969,698398,6897,691501,365,1.3253188010274943,1.0,2.0,oN5
3,random_1,random,0,925600,110507,815093,697573,6957,690616,358,1.3268862183599424,1.0,2.0,oN5
4,random_2,random,0,925600,110228,815372,698137,6974,691163,369,1.3258142742756793,1.0,2.0,oN5
5,random_3,random,0,925600,110086,815514,697695,6900,690795,376,1.326654197034521,1.0,2.0,oN5
6,random_4,random,0,925600,110640,814960,697275,7005,690270,356,1.3274533003477824,1.0,2.0,oN5
7,random_5,random,0,925600,110105,815495,697807,6941,690866,381,1.3264412652782216,1.0,2.0,oN5
8,random_6,random,0,925600,110181,815419,697764,6950,690814,369,1.3265230077791346,1.0,2.0,oN5
9,random_7,random,0,925600,110177,815423,697604,6965,690639,362,1.3268272544308806,1.0,2.0,oN5
10,random_8,random,0,925600,110236,815364,697673,6920,690753,367,1.3266960309485962,1.0,2.0,oN5
11,random_9,random,0,925600,110428,815172,697513,6974,690539,352,1.3270003569825939,1.0,2.0,oN5
0,junctions,real,0,228688,1495,227193,223104,58,223046,51,1.0250286861732645,1.0,1.0,oN55
1,junctions+hops,real,0,1887146,646265,1240881,829901,66710,763191,2515,2.273941108638259,1.0,6.0,oN55
2,random_0,random,0,228688,22886,205802,179422,1349,178073,314,1.2745817123875556,1.0,2.0,oN55
3,random_1,random,0,228688,22269,206419,179873,1352,178521,321,1.2713859222896156,1.0,2.0,oN55
4,random_2,random,0,228688,22598,206090,179612,1352,178260,285,1.2732334142484911,1.0,2.0,oN55
5,random_3,random,0,228688,22452,206236,179518,1351,178167,289,1.2739001102953464,1.0,2.0,oN55
6,random_4,random,0,228688,22827,205861,179488,1324,178164,315,1.2741130326261365,1.0,2.0,oN55
7,random_5,random,0,228688,22414,206274,179395,1309,178086,309,1.2747735444131665,1.0,2.0,oN55
8,random_6,random,0,228688,22574,206114,179336,1327,178009,300,1.275192933934068,1.0,2.0,oN55
9,random_7,random,0,228688,22598,206090,179882,1324,178558,286,1.2713223112929588,1.0,2.0,oN55
10,random_8,random,0,228688,22694,205994,179663,1342,178321,339,1.2728719881110746,1.0,2.0,oN55
11,random_9,random,0,228688,22972,205716,179405,1350,178055,290,1.274702488782364,1.0,2.0,oN55
0,junctions,real,0,258810,613,258197,253286,61,253225,31,1.0218093380605324,1.0,1.0,oN59
1,junctions+hops,real,0,1807012,633384,1173628,795139,46147,748992,2823,2.272573726103235,1.0,5.0,oN59
2,random_0,random,0,258810,46568,212242,186496,2300,184196,413,1.3877509437199727,1.0,2.0,oN59
3,random_1,random,0,258810,46452,212358,186852,2275,184577,417,1.3851069295485197,1.0,2.0,oN59
4,random_2,random,0,258810,47134,211676,186414,2320,184094,432,1.3883613891660498,1.0,2.0,oN59
5,random_3,random,0,258810,46515,212295,186565,2303,184262,398,1.3872376919572267,1.0,2.0,oN59
6,random_4,random,0,258810,47031,211779,186380,2310,184070,424,1.3886146582251315,1.0,2.0,oN59
7,random_5,random,0,258810,46859,211951,186324,2326,183998,395,1.389032008758936,1.0,2.0,oN59
8,random_6,random,0,258810,46556,212254,186519,2275,184244,386,1.387579817605713,1.0,2.0,oN59
9,random_7,random,0,258810,46974,211836,186273,2335,183938,397,1.3894123141840202,1.0,2.0,oN59
10,random_8,random,0,258810,46519,212291,186819,2290,184529,404,1.3853515970003052,1.0,2.0,oN59
11,random_9,random,0,258810,46761,212049,186473,2325,184148,428,1.387922112048393,1.0,2.0,oN59
0,junctions,real,0,334592,1421,333171,324861,81,324780,81,1.0299543497064898,1.0,1.0,oN62
1,junctions+hops,real,0,1880352,437946,1442406,974094,58116,915978,594,1.9303599036643282,1.0,5.0,oN62
2,random_0,random,0,334592,10189,324403,276480,1470,275010,110,1.2101851851851853,1.0,2.0,oN62
3,random_1,random,0,334592,10249,324343,275607,1483,274124,118,1.2140185118665345,1.0,2.0,oN62
4,random_2,random,0,334592,10237,324355,276069,1480,274589,106,1.2119868583578743,1.0,2.0,oN62
5,random_3,random,0,334592,10035,324557,276167,1474,274693,97,1.2115567754293597,1.0,2.0,oN62
6,random_4,random,0,334592,10071,324521,276369,1474,274895,113,1.2106712402621134,1.0,2.0,oN62
7,random_5,random,0,334592,10120,324472,276195,1471,274724,107,1.2114339506508083,1.0,2.0,oN62
8,random_6,random,0,334592,10181,324411,275838,1470,274368,120,1.2130018344100524,1.0,2.0,oN62
9,random_7,random,0,334592,10135,324457,275953,1477,274476,109,1.212496330896928,1.0,2.0,oN62
10,random_8,random,0,334592,10215,324377,275754,1491,274263,112,1.2133713382217484,1.0,2.0,oN62
11,random_9,random,0,334592,10222,324370,275814,1467,274347,104,1.2131073839616553,1.0,2.0,oN62
0,junctions,real,0,581118,1666,579452,560214,143,560071,56,1.0373143120307597,1.0,1.0,oN65
1,junctions+hops,real,0,2970016,1069053,1900963,1313886,103292,1210594,2071,2.2604822640624835,1.0,6.0,oN65
2,random_0,random,0,581118,76544,504574,416994,7721,409273,425,1.393588396955352,1.0,3.0,oN65
3,random_1,random,0,581118,76170,504948,416820,7755,409065,425,1.3941701453864979,1.0,3.0,oN65
4,random_2,random,0,581118,76684,504434,417147,7768,409379,403,1.3930772605340564,1.0,3.0,oN65
5,random_3,random,0,581118,75166,505952,417884,7598,410286,430,1.3906203635458645,1.0,3.0,oN65
6,random_4,random,0,581118,76306,504812,416965,7666,409299,396,1.393685321309942,1.0,3.0,oN65
7,random_5,random,0,581118,76577,504541,417125,7764,409361,405,1.3931507341923883,1.0,3.0,oN65
8,random_6,random,0,581118,76309,504809,417398,7674,409724,407,1.3922395411573607,1.0,3.0,oN65
9,random_7,random,0,581118,76515,504603,417186,7704,409482,422,1.392947030820785,1.0,3.0,oN65
10,random_8,random,0,581118,75890,505228,417647,7638,410009,387,1.3914094917478157,1.0,3.0,oN65
11,random_9,random,0,581118,76094,505024,417341,7665,409676,428,1.3924296917868122,1.0,3.0,oN65
0,junctions,real,0,94574,2250,92324,91202,70,91132,75,1.036972873401899,1.0,1.0,oNH131
1,junctions+hops,real,0,456332,161789,294543,222652,11589,211063,7968,2.0495302085766127,1.0,5.0,oNH131
2,random_0,random,0,94574,18496,76078,65378,1318,64060,1686,1.4465722414267796,1.0,3.0,oNH131
3,random_1,random,0,94574,18218,76356,65759,1285,64474,1710,1.4381909700573305,1.0,3.0,oNH131
4,random_2,random,0,94574,18061,76513,65719,1282,64437,1670,1.4390663278503932,1.0,3.0,oNH131
5,random_3,random,0,94574,17992,76582,65838,1289,64549,1671,1.4364652632218475,1.0,3.0,oNH131
6,random_4,random,0,94574,18220,76354,65781,1300,64481,1628,1.4377099770450434,1.0,3.0,oNH131
7,random_5,random,0,94574,18030,76544,65838,1278,64560,1634,1.4364652632218475,1.0,3.0,oNH131
8,random_6,random,0,94574,18353,76221,65650,1290,64360,1660,1.4405788271134805,1.0,3.0,oNH131
9,random_7,random,0,94574,17999,76575,65831,1290,64541,1585,1.436618006714162,1.0,3.0,oNH131
10,random_8,random,0,94574,17829,76745,66075,1273,64802,1594,1.431312902005297,1.0,3.0,oNH131
11,random_9,random,0,94574,18209,76365,65757,1295,64462,1629,1.4382347126541661,1.0,3.0,oNH131
0,junctions,real,0,84222,1877,82345,81266,55,81211,56,1.0363743755075923,1.0,1.0,oNH138
1,junctions+hops,real,0,390836,145663,245173,182176,10601,171575,6600,2.1453759002283506,1.0,5.0,oNH138
2,random_0,random,0,84222,16863,67359,57099,1372,55727,1422,1.4750170756055272,1.0,3.0,oNH138
3,random_1,random,0,84222,16543,67679,57273,1300,55973,1373,1.4705358545911686,1.0,3.0,oNH138
4,random_2,random,0,84222,16878,67344,57152,1360,55792,1368,1.47364921612542,1.0,3.0,oNH138
5,random_3,random,0,84222,16765,67457,57168,1341,55827,1420,1.4732367758186398,1.0,3.0,oNH138
6,random_4,random,0,84222,16816,67406,57237,1357,55880,1389,1.4714607683840872,1.0,3.0,oNH138
7,random_5,random,0,84222,16825,67397,57066,1350,55716,1438,1.4758700452108084,1.0,3.0,oNH138
8,random_6,random,0,84222,17100,67122,56886,1347,55539,1473,1.4805400274232676,1.0,3.0,oNH138
9,random_7,random,0,84222,17224,66998,56903,1394,55509,1490,1.4800977101383055,1.0,3.0,oNH138
10,random_8,random,0,84222,16866,67356,57139,1324,55815,1413,1.4739844939533417,1.0,3.0,oNH138
11,random_9,random,0,84222,17000,67222,56916,1365,55551,1406,1.4797596457938014,1.0,3.0,oNH138
0,junctions,real,0,71836,2389,69447,68597,56,68541,117,1.047217808358966,1.0,1.0,oNH140
1,junctions+hops,real,0,532530,242065,290465,210153,18096,192057,3425,2.5340109348902944,1.0,6.0,oNH140
2,random_0,random,0,71836,13310,58526,49229,1350,47879,476,1.4592211907615429,1.0,3.0,oNH140
3,random_1,random,0,71836,13532,58304,49149,1355,47794,484,1.4615963702211643,1.0,3.0,oNH140
4,random_2,random,0,71836,13391,58445,49365,1354,48011,478,1.4552010533778994,1.0,3.0,oNH140
5,random_3,random,0,71836,13231,58605,49298,1336,47962,460,1.4571787902146132,1.0,3.0,oNH140
6,random_4,random,0,71836,13330,58506,49398,1333,48065,455,1.4542289161504514,1.0,3.0,oNH140
7,random_5,random,0,71836,13427,58409,49097,1319,47778,465,1.4631443876407928,1.0,3.0,oNH140
8,random_6,random,0,71836,13405,58431,49223,1343,47880,469,1.4593990614143795,1.0,3.0,oNH140
9,random_7,random,0,71836,13439,58397,49165,1341,47824,451,1.4611207159564732,1.0,3.0,oNH140
10,random_8,random,0,71836,13368,58468,49162,1352,47810,518,1.4612098775476994,1.0,3.0,oNH140
11,random_9,random,0,71836,13233,58603,49391,1347,48044,470,1.4544350185256423,1.0,3.0,oNH140
0,junctions,real,0,65852,2423,63429,62653,69,62584,63,1.0510590075495188,1.0,1.0,oNH145
1,junctions+hops,real,0,467458,211028,256430,200890,10928,189962,4226,2.326935138633083,1.0,5.0,oNH145
2,random_0,random,0,65852,17972,47880,42244,1152,41092,566,1.558848593883155,1.0,3.0,oNH145
3,random_1,random,0,65852,18112,47740,41999,1135,40864,610,1.5679420938593776,1.0,3.0,oNH145
4,random_2,random,0,65852,17933,47919,42349,1165,41184,621,1.5549835887506198,1.0,3.0,oNH145
5,random_3,random,0,65852,18288,47564,42100,1186,40914,594,1.5641805225653207,1.0,3.0,oNH145
6,random_4,random,0,65852,18047,47805,42232,1173,41059,588,1.5592915324872134,1.0,3.0,oNH145
7,random_5,random,0,65852,18158,47694,42151,1192,40959,580,1.5622879646983465,1.0,3.0,oNH145
8,random_6,random,0,65852,18155,47697,42289,1184,41105,565,1.5571898129537232,1.0,3.0,oNH145
9,random_7,random,0,65852,17965,47887,42253,1173,41080,596,1.5585165550375122,1.0,3.0,oNH145
10,random_8,random,0,65852,18225,47627,42162,1183,40979,613,1.5618803662065366,1.0,3.0,oNH145
11,random_9,random,0,65852,18280,47572,42157,1207,40950,621,1.5620656118794032,1.0,3.0,oNH145
0,junctions,real,0,63898,1669,62229,61436,60,61376,49,1.0400742235822644,1.0,1.0,oNH146
1,junctions+hops,real,0,592340,284904,307436,243417,20433,222984,8138,2.4334372701988767,1.0,7.0,oNH146
2,random_0,random,0,63898,11542,52356,44315,992,43323,922,1.4419045469931175,1.0,3.0,oNH146
3,random_1,random,0,63898,11496,52402,44574,1004,43570,847,1.4335262709202674,1.0,3.0,oNH146
4,random_2,random,0,63898,11283,52615,44670,977,43693,851,1.4304454891426013,1.0,3.0,oNH146
5,random_3,random,0,63898,11466,52432,44436,997,43439,838,1.4379782158610135,1.0,3.0,oNH146
6,random_4,random,0,63898,11556,52342,44471,993,43478,909,1.4368464842256752,1.0,3.0,oNH146
7,random_5,random,0,63898,11723,52175,44411,1020,43391,897,1.4387876877350205,1.0,3.0,oNH146
8,random_6,random,0,63898,11499,52399,44490,997,43493,896,1.43623286131715,1.0,3.0,oNH146
9,random_7,random,0,63898,11591,52307,44420,989,43431,881,1.4384961728950922,1.0,3.0,oNH146
10,random_8,random,0,63898,11482,52416,44540,993,43547,874,1.4346205657835653,1.0,3.0,oNH146
11,random_9,random,0,63898,11414,52484,44729,978,43751,893,1.4285586532227414,1.0,3.0,oNH146
0,junctions,real,0,46568,1836,44732,44088,66,44022,54,1.0562511340954455,1.0,1.0,oNH160
1,junctions+hops,real,0,298198,145072,153126,114765,7839,106926,5302,2.5983357295342655,1.0,6.0,oNH160
2,random_0,random,0,46568,13791,32777,28310,1007,27303,836,1.6449311197456729,1.0,3.0,oNH160
3,random_1,random,0,46568,13921,32647,28097,1028,27069,856,1.6574011460298252,1.0,4.0,oNH160
4,random_2,random,0,46568,13636,32932,28369,1003,27366,828,1.641510099051782,1.0,3.0,oNH160
5,random_3,random,0,46568,13781,32787,28188,1034,27154,875,1.652050517950901,1.0,4.0,oNH160
6,random_4,random,0,46568,13784,32784,28146,1017,27129,843,1.6545157393590564,1.0,4.0,oNH160
7,random_5,random,0,46568,13771,32797,28162,1008,27154,824,1.6535757403593494,1.0,3.0,oNH160
8,random_6,random,0,46568,13642,32926,28330,993,27337,819,1.6437698552770914,1.0,3.0,oNH160
9,random_7,random,0,46568,13646,32922,28358,1013,27345,811,1.6421468368714296,1.0,3.0,oNH160
10,random_8,random,0,46568,13746,32822,28310,1037,27273,818,1.6449311197456729,1.0,4.0,oNH160
11,random_9,random,0,46568,13760,32808,28283,1021,27262,809,1.6465014319555917,1.0,3.0,oNH160
0,junctions,real,0,35314,1041,34273,33698,60,33638,42,1.047955368271114,1.0,1.0,oNH171
1,junctions+hops,real,0,304190,182048,122142,86389,10411,75978,1034,3.5211658891757054,1.0,10.0,oNH171
2,random_0,random,0,35314,10614,24700,20367,982,19385,143,1.7338832425001227,1.0,4.0,oNH171
3,random_1,random,0,35314,10554,24760,20393,963,19430,138,1.7316726327661451,1.0,4.0,oNH171
4,random_2,random,0,35314,10669,24645,20391,990,19401,130,1.7318424795252807,1.0,4.0,oNH171
5,random_3,random,0,35314,10633,24681,20559,986,19573,125,1.7176905491512233,1.0,4.0,oNH171
6,random_4,random,0,35314,10834,24480,20302,994,19308,115,1.7394345384691163,1.0,4.0,oNH171
7,random_5,random,0,35314,10420,24894,20569,954,19615,126,1.7168554621031649,1.0,4.0,oNH171
8,random_6,random,0,35314,10721,24593,20234,958,19276,126,1.7452802214095087,1.0,4.0,oNH171
9,random_7,random,0,35314,10731,24583,20401,991,19410,116,1.73099357874614,1.0,4.0,oNH171
10,random_8,random,0,35314,10627,24687,20338,963,19375,125,1.7363555905202084,1.0,4.0,oNH171
11,random_9,random,0,35314,10606,24708,20292,960,19332,122,1.7402917405874236,1.0,4.0,oNH171
0,junctions,real,0,34910,2437,32473,31943,60,31883,64,1.0928841999812164,1.0,1.0,oNH176
1,junctions+hops,real,0,261742,145696,116046,84443,8405,76038,6401,3.099629335764954,1.0,8.0,oNH176
2,random_0,random,0,34910,10492,24418,20340,735,19605,884,1.716322517207473,1.0,4.0,oNH176
3,random_1,random,0,34910,10210,24700,20408,733,19675,872,1.7106036848294786,1.0,4.0,oNH176
4,random_2,random,0,34910,10290,24620,20384,718,19666,862,1.7126177394034536,1.0,4.0,oNH176
5,random_3,random,0,34910,10305,24605,20347,720,19627,884,1.7157320489507053,1.0,4.0,oNH176
6,random_4,random,0,34910,10218,24692,20483,711,19772,846,1.7043401845432797,1.0,4.0,oNH176
7,random_5,random,0,34910,10337,24573,20364,728,19636,896,1.714299744647417,1.0,4.0,oNH176
8,random_6,random,0,34910,10457,24453,20379,752,19627,833,1.71303793120369,1.0,4.0,oNH176
9,random_7,random,0,34910,10207,24703,20395,712,19683,829,1.711694042657514,1.0,4.0,oNH176
10,random_8,random,0,34910,10337,24573,20348,729,19619,882,1.7156477295065855,1.0,4.0,oNH176
11,random_9,random,0,34910,10285,24625,20455,734,19721,819,1.7066731850403325,1.0,4.0,oNH176
0,junctions,real,0,27204,1571,25633,25167,63,25104,48,1.0809393253069495,1.0,1.0,oNH179
1,junctions+hops,real,0,240852,144077,96775,69459,7599,61860,1838,3.46754200319613,1.0,8.0,oNH179
2,random_0,random,0,27204,9164,18040,15257,713,14544,194,1.783050403093662,1.0,4.0,oNH179
3,random_1,random,0,27204,9193,18011,15230,720,14510,207,1.7862114248194354,1.0,4.0,oNH179
4,random_2,random,0,27204,9180,18024,15125,726,14399,190,1.798611570247934,1.0,4.0,oNH179
5,random_3,random,0,27204,9143,18061,15349,732,14617,209,1.772363020392208,1.0,4.0,oNH179
6,random_4,random,0,27204,9010,18194,15313,720,14593,204,1.7765297459674787,1.0,4.0,oNH179
7,random_5,random,0,27204,9014,18190,15396,706,14690,193,1.7669524551831643,1.0,4.0,oNH179
8,random_6,random,0,27204,9143,18061,15313,718,14595,223,1.7765297459674787,1.0,4.0,oNH179
9,random_7,random,0,27204,9059,18145,15302,716,14586,218,1.7778068226375636,1.0,4.0,oNH179
10,random_8,random,0,27204,9048,18156,15290,706,14584,193,1.7792020928711576,1.0,4.0,oNH179
11,random_9,random,0,27204,8930,18274,15342,702,14640,200,1.7731716855690263,1.0,4.0,oNH179
0,junctions,real,0,29206,2361,26845,26297,61,26236,62,1.1106209833821348,1.0,1.0,oNH186
1,junctions+hops,real,0,252134,155237,96897,67867,7853,60014,4395,3.7151192774102286,1.0,9.0,oNH186
2,random_0,random,0,29206,10322,18884,15777,757,15020,519,1.8511757621854599,1.0,4.0,oNH186
3,random_1,random,0,29206,10327,18879,15863,774,15089,499,1.8411397591880476,1.0,4.0,oNH186
4,random_2,random,0,29206,10221,18985,15901,729,15172,508,1.8367398276837934,1.0,4.0,oNH186
5,random_3,random,0,29206,10186,19020,15880,762,15118,489,1.839168765743073,1.0,4.0,oNH186
6,random_4,random,0,29206,10215,18991,15761,742,15019,498,1.8530550091999238,1.0,4.0,oNH186
7,random_5,random,0,29206,10261,18945,15843,766,15077,528,1.8434639904058574,1.0,4.0,oNH186
8,random_6,random,0,29206,10057,19149,15818,728,15090,509,1.846377544569478,1.0,4.0,oNH186
9,random_7,random,0,29206,10203,19003,15766,752,15014,516,1.8524673347710263,1.0,4.0,oNH186
10,random_8,random,0,29206,10077,19129,16039,744,15295,488,1.820936467360808,1.0,4.0,oNH186
11,random_9,random,0,29206,10180,19026,15837,749,15088,463,1.844162404495801,1.0,4.0,oNH186
0,junctions,real,0,24284,995,23289,22839,74,22765,43,1.0632689697447348,1.0,1.0,oNH188
1,junctions+hops,real,0,256536,173419,83117,57906,8162,49744,1603,4.430214485545539,2.0,12.0,oNH188
2,random_0,random,0,24284,8801,15483,12675,758,11917,165,1.9158974358974359,1.0,5.0,oNH188
3,random_1,random,0,24284,9150,15134,12489,802,11687,165,1.9444310993674434,1.0,5.0,oNH188
4,random_2,random,0,24284,8915,15369,12666,775,11891,163,1.9172588030948998,1.0,5.0,oNH188
5,random_3,random,0,24284,9134,15150,12433,758,11675,159,1.9531890935413818,1.0,5.0,oNH188
6,random_4,random,0,24284,8735,15549,12625,743,11882,172,1.9234851485148514,1.0,5.0,oNH188
7,random_5,random,0,24284,9040,15244,12542,791,11751,154,1.9362143198851858,1.0,5.0,oNH188
8,random_6,random,0,24284,8731,15553,12786,747,12039,137,1.899264820897857,1.0,5.0,oNH188
9,random_7,random,0,24284,8906,15378,12654,790,11864,154,1.9190769717085507,1.0,5.0,oNH188
10,random_8,random,0,24284,8963,15321,12498,760,11738,149,1.9430308849415907,1.0,5.0,oNH188
11,random_9,random,0,24284,8873,15411,12635,761,11874,139,1.9219628017411952,1.0,5.0,oNH188
0,junctions,real,0,18872,3142,15730,15593,56,15537,129,1.210286667094209,1.0,1.0,oNH193
1,junctions+hops,real,0,89726,38381,51345,39420,1720,37700,1724,2.276154236428209,1.0,4.0,oNH193
2,random_0,random,0,18872,5850,13022,11482,329,11153,339,1.6436160947570109,1.0,3.0,oNH193
3,random_1,random,0,18872,5834,13038,11515,333,11182,336,1.638905775075988,1.0,3.0,oNH193
4,random_2,random,0,18872,5799,13073,11461,328,11133,346,1.6466276939185063,1.0,3.0,oNH193
5,random_3,random,0,18872,5791,13081,11503,347,11156,360,1.6406154916108842,1.0,3.0,oNH193
6,random_4,random,0,18872,5887,12985,11445,348,11097,347,1.6489296636085626,1.0,3.0,oNH193
7,random_5,random,0,18872,5906,12966,11487,336,11151,361,1.6429006703229738,1.0,3.0,oNH193
8,random_6,random,0,18872,5958,12914,11374,333,11041,383,1.6592227888165993,1.0,3.0,oNH193
9,random_7,random,0,18872,5856,13016,11434,340,11094,344,1.6505160048976737,1.0,3.0,oNH193
10,random_8,random,0,18872,5918,12954,11418,332,11086,354,1.652828866701699,1.0,3.0,oNH193
11,random_9,random,0,18872,5791,13081,11446,313,11133,360,1.6487856019570155,1.0,3.0,oNH193
0,junctions,real,0,371582,2224,369358,361760,132,361628,341,1.0271505970809376,1.0,1.0,oNH26
1,junctions+hops,real,0,2928886,837763,2091123,1424211,87464,1336747,4840,2.0564972465456313,1.0,5.0,oNH26
2,random_0,random,0,371582,31058,340524,300703,2040,298663,609,1.2357109839276628,1.0,2.0,oNH26
3,random_1,random,0,371582,30748,340834,300910,2063,298847,653,1.2348609218703266,1.0,2.0,oNH26
4,random_2,random,0,371582,30490,341092,301055,1988,299067,592,1.2342661639899686,1.0,2.0,oNH26
5,random_3,random,0,371582,30780,340802,301206,2051,299155,642,1.2336474041021759,1.0,2.0,oNH26
6,random_4,random,0,371582,30886,340696,301281,2063,299218,623,1.233340303570421,1.0,2.0,oNH26
7,random_5,random,0,371582,31122,340460,300546,2051,298495,621,1.2363564978405968,1.0,2.0,oNH26
8,random_6,random,0,371582,30850,340732,300798,2026,298772,634,1.2353207135685742,1.0,2.0,oNH26
9,random_7,random,0,371582,30489,341093,301383,2022,299361,658,1.2329228921339292,1.0,2.0,oNH26
10,random_8,random,0,371582,30908,340674,301244,2048,299196,591,1.2334917873882965,1.0,2.0,oNH26
11,random_9,random,0,371582,30937,340645,300863,2026,298837,649,1.2350538284867199,1.0,2.0,oNH26
0,junctions,real,0,203956,1323,202633,199375,140,199235,38,1.022976802507837,1.0,1.0,oNH86
1,junctions+hops,real,0,1385648,540646,845002,611469,32666,578803,1465,2.266096891256957,1.0,5.0,oNH86
2,random_0,random,0,203956,45491,158465,139921,3483,136438,215,1.4576511031224761,1.0,3.0,oNH86
3,random_1,random,0,203956,45744,158212,139739,3526,136213,227,1.4595495888764054,1.0,3.0,oNH86
4,random_2,random,0,203956,45702,158254,139856,3501,136355,206,1.4583285665255692,1.0,3.0,oNH86
5,random_3,random,0,203956,45913,158043,139928,3583,136345,217,1.4575781830655765,1.0,3.0,oNH86
6,random_4,random,0,203956,45674,158282,139795,3521,136274,223,1.458964912908187,1.0,3.0,oNH86
7,random_5,random,0,203956,45773,158183,139987,3577,136410,241,1.4569638609299436,1.0,3.0,oNH86
8,random_6,random,0,203956,45659,158297,140062,3517,136545,234,1.4561836900801073,1.0,3.0,oNH86
9,random_7,random,0,203956,45318,158638,140242,3496,136746,211,1.4543146846165913,1.0,3.0,oNH86
10,random_8,random,0,203956,45540,158416,140333,3514,136819,227,1.4533716232105065,1.0,3.0,oNH86
11,random_9,random,0,203956,45821,158135,139786,3504,136282,214,1.459058847094845,1.0,3.0,oNH86
0,junctions,real,0,190548,1415,189133,186266,54,186212,49,1.022988629164743,1.0,1.0,oNH93
1,junctions+hops,real,0,1120766,261141,859625,616353,29244,587109,530,1.8183832965849116,1.0,4.0,oNH93
2,random_0,random,0,190548,10636,179912,156538,1318,155220,95,1.2172635398433607,1.0,2.0,oNH93
3,random_1,random,0,190548,10288,180260,157009,1255,155754,93,1.2136119585501468,1.0,2.0,oNH93
4,random_2,random,0,190548,10479,180069,156524,1266,155258,90,1.2173724157317727,1.0,2.0,oNH93
5,random_3,random,0,190548,10433,180115,156626,1298,155328,103,1.2165796227957044,1.0,2.0,oNH93
6,random_4,random,0,190548,10600,179948,156793,1285,155508,91,1.215283845579841,1.0,2.0,oNH93
7,random_5,random,0,190548,10468,180080,156777,1267,155510,92,1.2154078723282113,1.0,2.0,oNH93
8,random_6,random,0,190548,10641,179907,156626,1287,155339,97,1.2165796227957044,1.0,2.0,oNH93
9,random_7,random,0,190548,10593,179955,156715,1291,155424,107,1.2158887151836135,1.0,2.0,oNH93
10,random_8,random,0,190548,10515,180033,156736,1274,155462,86,1.215725806451613,1.0,2.0,oNH93
11,random_9,random,0,190548,10313,180235,156861,1259,155602,91,1.2147570141717827,1.0,2.0,oNH93
0,junctions,real,0,141618,450,141168,137141,63,137078,17,1.0326452337375402,1.0,1.0,oS101
1,junctions+hops,real,0,1229070,525132,703938,463327,49620,413707,1939,2.6527053247490433,1.0,6.0,oS101
2,random_0,random,0,141618,20098,121520,104344,1202,103142,216,1.3572222648163765,1.0,2.0,oS101
3,random_1,random,0,141618,20153,121465,104162,1203,102959,222,1.359593709798199,1.0,2.0,oS101
4,random_2,random,0,141618,20455,121163,103990,1230,102760,221,1.361842484854313,1.0,2.0,oS101
5,random_3,random,0,141618,20042,121576,104312,1188,103124,218,1.3576386225937571,1.0,2.0,oS101
6,random_4,random,0,141618,20003,121615,104370,1189,103181,206,1.3568841621155505,1.0,2.0,oS101
7,random_5,random,0,141618,20075,121543,104456,1200,103256,212,1.3557670215210231,1.0,2.0,oS101
8,random_6,random,0,141618,20197,121421,104113,1194,102919,237,1.360233592346777,1.0,2.0,oS101
9,random_7,random,0,141618,19953,121665,104151,1204,102947,214,1.3597373044905954,1.0,2.0,oS101
10,random_8,random,0,141618,20021,121597,104320,1193,103127,231,1.357534509202454,1.0,2.0,oS101
11,random_9,random,0,141618,20234,121384,104096,1228,102868,223,1.360455733169382,1.0,2.0,oS101
0,junctions,real,0,117334,553,116781,114378,80,114298,17,1.0258441308643271,1.0,1.0,oS114
1,junctions+hops,real,0,1105942,655637,450305,335873,43849,292024,767,3.29273862442054,1.0,10.0,oS114
2,random_0,random,0,117334,27928,89406,73149,3058,70091,82,1.6040410668635252,1.0,4.0,oS114
3,random_1,random,0,117334,27997,89337,73022,2996,70026,75,1.6068308181096107,1.0,4.0,oS114
4,random_2,random,0,117334,27687,89647,73305,2992,70313,83,1.600627515176318,1.0,4.0,oS114
5,random_3,random,0,117334,27869,89465,73248,3011,70237,88,1.6018730886850152,1.0,4.0,oS114
6,random_4,random,0,117334,27255,90079,73515,2929,70586,82,1.5960552268244577,1.0,4.0,oS114
7,random_5,random,0,117334,28387,88947,73203,3077,70126,83,1.6028578063740557,1.0,4.0,oS114
8,random_6,random,0,117334,27673,89661,73516,2990,70526,84,1.596033516513412,1.0,4.0,oS114
9,random_7,random,0,117334,27752,89582,73205,2965,70240,83,1.6028140154361041,1.0,4.0,oS114
10,random_8,random,0,117334,27874,89460,73306,3033,70273,87,1.6006056802990205,1.0,4.0,oS114
11,random_9,random,0,117334,28064,89270,72885,3073,69812,78,1.6098511353502092,1.0,4.0,oS114
0,junctions,real,0,92908,1479,91429,89234,163,89071,55,1.0411726471972567,1.0,1.0,oS122
1,junctions+hops,real,0,854758,451083,403675,299177,30184,268993,883,2.8570311220448095,1.0,8.0,oS122
2,random_0,random,0,92908,20263,72645,60970,2146,58824,123,1.5238313924881088,1.0,4.0,oS122
3,random_1,random,0,92908,20520,72388,60817,2180,58637,119,1.527664962099413,1.0,4.0,oS122
4,random_2,random,0,92908,20069,72839,61334,2150,59184,114,1.514787882740405,1.0,4.0,oS122
5,random_3,random,0,92908,20273,72635,61062,2168,58894,97,1.521535488519865,1.0,4.0,oS122
6,random_4,random,0,92908,20183,72725,61120,2167,58953,109,1.5200916230366492,1.0,4.0,oS122
7,random_5,random,0,92908,20448,72460,60842,2191,58651,111,1.5270372440090727,1.0,4.0,oS122
8,random_6,random,0,92908,20298,72610,60995,2163,58832,93,1.5232068202311664,1.0,4.0,oS122
9,random_7,random,0,92908,20080,72828,60945,2136,58809,107,1.52445647715153,1.0,4.0,oS122
10,random_8,random,0,92908,20161,72747,61116,2172,58944,99,1.5201911119837686,1.0,4.0,oS122
11,random_9,random,0,92908,20200,72708,61115,2150,58965,116,1.52021598625542,1.0,4.0,oS122
0,junctions,real,0,80282,1019,79263,78151,103,78048,41,1.0272677253010198,1.0,1.0,oS125
1,junctions+hops,real,0,588024,250739,337285,246799,18183,228616,2345,2.382602846851081,1.0,6.0,oS125
2,random_0,random,0,80282,15688,64594,55676,1416,54260,314,1.4419498527193046,1.0,3.0,oS125
3,random_1,random,0,80282,15476,64806,55751,1396,54355,332,1.440010044662876,1.0,3.0,oS125
4,random_2,random,0,80282,15573,64709,55672,1403,54269,342,1.4420534559563156,1.0,3.0,oS125
5,random_3,random,0,80282,15764,64518,55628,1432,54196,340,1.4431940749262961,1.0,3.0,oS125
6,random_4,random,0,80282,15349,64933,55785,1413,54372,328,1.4391323832571479,1.0,3.0,oS125
7,random_5,random,0,80282,15743,64539,55658,1430,54228,308,1.4424161845556793,1.0,3.0,oS125
8,random_6,random,0,80282,15798,64484,55579,1429,54150,333,1.4444664351643606,1.0,3.0,oS125
9,random_7,random,0,80282,15916,64366,55330,1463,53867,339,1.4509669257184168,1.0,3.0,oS125
10,random_8,random,0,80282,15473,64809,55944,1430,54514,352,1.435042185042185,1.0,3.0,oS125
11,random_9,random,0,80282,15375,64907,55941,1403,54538,298,1.4351191433832073,1.0,3.0,oS125
0,junctions,real,0,821574,543,821031,784145,85,784060,26,1.0477322433988612,1.0,1.0,oS13
1,junctions+hops,real,0,3995400,613106,3382294,2384222,90072,2294150,129,1.6757667700407093,1.0,4.0,oS13
2,random_0,random,0,821574,10691,810883,704622,1714,702908,25,1.165978354351695,1.0,2.0,oS13
3,random_1,random,0,821574,11089,810485,703793,1799,701994,27,1.1673517639419546,1.0,2.0,oS13
4,random_2,random,0,821574,10741,810833,704158,1749,702409,30,1.166746667651294,1.0,2.0,oS13
5,random_3,random,0,821574,11015,810559,703883,1771,702112,32,1.1672025038252096,1.0,2.0,oS13
6,random_4,random,0,821574,11054,810520,704433,1760,702673,32,1.166291187380489,1.0,2.0,oS13
7,random_5,random,0,821574,11191,810383,704061,1814,702247,26,1.1669074128520114,1.0,2.0,oS13
8,random_6,random,0,821574,10996,810578,704453,1771,702682,31,1.1662580754145415,1.0,2.0,oS13
9,random_7,random,0,821574,11125,810449,704014,1818,702196,36,1.1669853156329277,1.0,2.0,oS13
10,random_8,random,0,821574,11165,810409,704092,1801,702291,27,1.1668560358589501,1.0,2.0,oS13
11,random_9,random,0,821574,11119,810455,704345,1794,702551,35,1.1664369023702872,1.0,2.0,oS13
0,junctions,real,0,226454,2837,223617,219475,131,219344,87,1.031798610320082,1.0,1.0,oS130
1,junctions+hops,real,0,1294158,543802,750356,540377,36382,503995,2075,2.39491688210268,1.0,5.0,oS130
2,random_0,random,0,226454,52236,174218,148861,3563,145298,363,1.5212446510503086,1.0,3.0,oS130
3,random_1,random,0,226454,51763,174691,148586,3541,145045,360,1.524060140255475,1.0,3.0,oS130
4,random_2,random,0,226454,52158,174296,148734,3573,145161,362,1.5225436013285463,1.0,3.0,oS130
5,random_3,random,0,226454,52111,174343,148870,3564,145306,365,1.5211526835494056,1.0,3.0,oS130
6,random_4,random,0,226454,52324,174130,148804,3592,145212,404,1.5218273702319831,1.0,3.0,oS130
7,random_5,random,0,226454,52346,174108,148945,3669,145276,351,1.5203867199301755,1.0,3.0,oS130
8,random_6,random,0,226454,52264,174190,148525,3561,144964,369,1.524686079784548,1.0,3.0,oS130
9,random_7,random,0,226454,51711,174743,149247,3589,145658,367,1.5173102306914041,1.0,3.0,oS130
10,random_8,random,0,226454,51800,174654,149056,3568,145488,371,1.519254508372692,1.0,3.0,oS130
11,random_9,random,0,226454,52251,174203,148643,3633,145010,374,1.5234757102588081,1.0,3.0,oS130
0,junctions,real,0,76302,1828,74474,73520,65,73455,66,1.0378400435255712,1.0,1.0,oS132
1,junctions+hops,real,0,425136,137527,287609,221185,12129,209056,3801,1.9220833239143704,1.0,5.0,oS132
2,random_0,random,0,76302,9449,66853,57599,918,56681,675,1.3247104984461535,1.0,3.0,oS132
3,random_1,random,0,76302,9227,67075,57789,880,56909,725,1.320355084877745,1.0,3.0,oS132
4,random_2,random,0,76302,9161,67141,57607,871,56736,734,1.3245265332338083,1.0,3.0,oS132
5,random_3,random,0,76302,9261,67041,57638,895,56743,683,1.3238141503868974,1.0,3.0,oS132
6,random_4,random,0,76302,8984,67318,57884,874,57010,670,1.3181881003386082,1.0,3.0,oS132
7,random_5,random,0,76302,9137,67165,57593,873,56720,664,1.3248485058948136,1.0,3.0,oS132
8,random_6,random,0,76302,9102,67200,57790,871,56919,674,1.320332237411317,1.0,3.0,oS132
9,random_7,random,0,76302,9244,67058,57522,892,56630,676,1.326483780118911,1.0,3.0,oS132
10,random_8,random,0,76302,9331,66971,57612,897,56715,694,1.3244115809206416,1.0,3.0,oS132
11,random_9,random,0,76302,9370,66932,57482,889,56593,710,1.3274068404022128,1.0,3.0,oS132
0,junctions,real,0,1444820,3750,1441070,1340087,446,1339641,91,1.0781538810539912,1.0,2.0,oS14
1,junctions+hops,real,0,8890666,2630653,6260013,4020497,327641,3692856,2855,2.211335066286581,1.0,5.0,oS14
2,random_0,random,0,1444820,77175,1367645,1147912,7367,1140545,445,1.25865048888765,1.0,2.0,oS14
3,random_1,random,0,1444820,76587,1368233,1148993,7360,1141633,478,1.25746632050848,1.0,2.0,oS14
4,random_2,random,0,1444820,75861,1368959,1149518,7260,1142258,473,1.2568920190897401,1.0,2.0,oS14
5,random_3,random,0,1444820,76596,1368224,1149170,7318,1141852,463,1.2572726402534002,1.0,2.0,oS14
6,random_4,random,0,1444820,75812,1369008,1149548,7258,1142290,456,1.2568592177099174,1.0,2.0,oS14
7,random_5,random,0,1444820,76347,1368473,1148916,7279,1141637,459,1.257550595517862,1.0,2.0,oS14
8,random_6,random,0,1444820,76759,1368061,1148786,7340,1141446,472,1.257692903639146,1.0,2.0,oS14
9,random_7,random,0,1444820,76528,1368292,1148782,7356,1141426,448,1.2576972828613262,1.0,2.0,oS14
10,random_8,random,0,1444820,76488,1368332,1149297,7358,1141939,464,1.2571337086932273,1.0,2.0,oS14
11,random_9,random,0,1444820,76486,1368334,1149271,7394,1141877,453,1.2571621488752436,1.0,2.0,oS14
0,junctions,real,0,43556,1177,42379,41685,87,41598,55,1.044884250929591,1.0,1.0,oS144
1,junctions+hops,real,0,562016,354918,207098,155076,15961,139115,3612,3.6241326833294645,1.0,8.0,oS144
2,random_0,random,0,43556,15110,28446,24512,1268,23244,304,1.7769255874673628,1.0,5.0,oS144
3,random_1,random,0,43556,15202,28354,24397,1250,23147,264,1.7853014714923967,1.0,5.0,oS144
4,random_2,random,0,43556,15254,28302,24437,1253,23184,299,1.7823791791136392,1.0,5.0,oS144
5,random_3,random,0,43556,14959,28597,24516,1224,23292,285,1.776635666503508,1.0,4.0,oS144
6,random_4,random,0,43556,15121,28435,24513,1261,23252,284,1.7768530983559745,1.0,5.0,oS144
7,random_5,random,0,43556,15055,28501,24443,1232,23211,312,1.7819416601890112,1.0,5.0,oS144
8,random_6,random,0,43556,15066,28490,24539,1249,23290,286,1.7749704551937733,1.0,5.0,oS144
9,random_7,random,0,43556,15356,28200,24280,1272,23008,272,1.7939044481054365,1.0,5.0,oS144
10,random_8,random,0,43556,15377,28179,24287,1272,23015,272,1.7933874089018818,1.0,5.0,oS144
11,random_9,random,0,43556,15113,28443,24457,1234,23223,284,1.7809216175328126,1.0,5.0,oS144
0,junctions,real,0,60566,2120,58446,57706,81,57625,104,1.049561570720549,1.0,1.0,oS150
1,junctions+hops,real,0,317276,101684,215592,154344,9532,144812,4019,2.0556419426735086,1.0,5.0,oS150
2,random_0,random,0,60566,7335,53231,44918,623,44295,752,1.348368137494991,1.0,3.0,oS150
3,random_1,random,0,60566,7166,53400,45204,603,44601,786,1.3398371825502169,1.0,2.0,oS150
4,random_2,random,0,60566,7505,53061,44921,624,44297,770,1.348278088199283,1.0,3.0,oS150
5,random_3,random,0,60566,7327,53239,44982,619,44363,756,1.346449690987506,1.0,3.0,oS150
6,random_4,random,0,60566,7289,53277,45070,627,44443,779,1.3438207233192812,1.0,3.0,oS150
7,random_5,random,0,60566,7589,52977,44932,633,44299,776,1.3479480103267159,1.0,2.0,oS150
8,random_6,random,0,60566,7395,53171,45027,612,44415,767,1.345104048681902,1.0,2.0,oS150
9,random_7,random,0,60566,7421,53145,45068,623,44445,794,1.3438803585692731,1.0,2.0,oS150
10,random_8,random,0,60566,7363,53203,44957,597,44360,799,1.3471984340592122,1.0,3.0,oS150
11,random_9,random,0,60566,7353,53213,44996,636,44360,762,1.3460307582896258,1.0,3.0,oS150
0,junctions,real,0,43040,2021,41019,40572,93,40479,70,1.0608301291531106,1.0,1.0,oS161
1,junctions+hops,real,0,208162,51421,156741,116441,4504,111937,2192,1.7877036439054972,1.0,4.0,oS161
2,random_0,random,0,43040,4787,38253,33557,373,33184,466,1.2825937956313138,1.0,2.0,oS161
3,random_1,random,0,43040,4752,38288,33574,382,33192,458,1.281944361708465,1.0,2.0,oS161
4,random_2,random,0,43040,4774,38266,33478,378,33100,444,1.2856204074317463,1.0,2.0,oS161
5,random_3,random,0,43040,4761,38279,33405,384,33021,440,1.2884298757671007,1.0,2.0,oS161
6,random_4,random,0,43040,4825,38215,33480,388,33092,469,1.2855436081242533,1.0,2.0,oS161
7,random_5,random,0,43040,4795,38245,33672,388,33284,473,1.2782133523402233,1.0,2.0,oS161
8,random_6,random,0,43040,4806,38234,33493,386,33107,479,1.2850446361926373,1.0,2.0,oS161
9,random_7,random,0,43040,4690,38350,33514,363,33151,472,1.284239422330966,1.0,2.0,oS161
10,random_8,random,0,43040,4909,38131,33333,400,32933,475,1.2912129121291214,1.0,2.0,oS161
11,random_9,random,0,43040,4742,38298,33457,372,33085,493,1.2864273545147502,1.0,2.0,oS161
0,junctions,real,0,124228,2188,122040,119418,149,119269,65,1.040278684955367,1.0,1.0,oS163
1,junctions+hops,real,0,921570,541384,380186,272296,34058,238238,5017,3.3844419308399685,1.0,9.0,oS163
2,random_0,random,0,124228,36993,87235,71246,2806,68440,683,1.743648766246526,1.0,4.0,oS163
3,random_1,random,0,124228,37035,87193,71437,2848,68589,697,1.7389867995576522,1.0,4.0,oS163
4,random_2,random,0,124228,36925,87303,71487,2787,68700,672,1.7377705037279505,1.0,4.0,oS163
5,random_3,random,0,124228,37157,87071,71293,2846,68447,679,1.742499263602317,1.0,4.0,oS163
6,random_4,random,0,124228,37163,87065,71289,2855,68434,670,1.7425970346056194,1.0,4.0,oS163
7,random_5,random,0,124228,37274,86954,71068,2817,68251,670,1.7480159846907188,1.0,4.0,oS163
8,random_6,random,0,124228,37798,86430,70849,2906,67943,696,1.7534192437437366,1.0,4.0,oS163
9,random_7,random,0,124228,37227,87001,71306,2874,68432,667,1.7421815835974532,1.0,4.0,oS163
10,random_8,random,0,124228,36849,87379,71314,2795,68519,674,1.7419861457778276,1.0,4.0,oS163
11,random_9,random,0,124228,37711,86517,71025,2909,68116,683,1.749074269623372,1.0,4.0,oS163
0,junctions,real,0,28816,1087,27729,27378,61,27317,65,1.052523924318796,1.0,1.0,oS165
1,junctions+hops,real,0,257142,126828,130314,95691,9110,86581,4980,2.68721196350754,1.0,7.0,oS165
2,random_0,random,0,28816,5493,23323,19559,513,19046,601,1.4732859553146889,1.0,3.0,oS165
3,random_1,random,0,28816,5439,23377,19638,516,19122,558,1.4673592015480192,1.0,3.0,oS165
4,random_2,random,0,28816,5376,23440,19724,507,19217,558,1.4609612654633948,1.0,3.0,oS165
5,random_3,random,0,28816,5550,23266,19567,517,19050,574,1.4726835999386723,1.0,3.0,oS165
6,random_4,random,0,28816,5349,23467,19623,499,19124,574,1.4684808642919023,1.0,3.0,oS165
7,random_5,random,0,28816,5594,23222,19584,542,19042,560,1.47140522875817,1.0,3.0,oS165
8,random_6,random,0,28816,5396,23420,19650,521,19129,552,1.4664631043256997,1.0,3.0,oS165
9,random_7,random,0,28816,5395,23421,19674,515,19159,567,1.4646741892853512,1.0,3.0,oS165
10,random_8,random,0,28816,5246,23570,19829,493,19336,576,1.4532250743860002,1.0,3.0,oS165
11,random_9,random,0,28816,5379,23437,19718,506,19212,595,1.46140582209149,1.0,3.0,oS165
0,junctions,real,0,34384,2054,32330,31963,65,31898,94,1.0757438288020524,1.0,1.0,oS167
1,junctions+hops,real,0,185190,61143,124047,93578,4218,89360,1740,1.9789907884331788,1.0,4.0,oS167
2,random_0,random,0,34384,6340,28044,24690,480,24210,316,1.3926285945727015,1.0,2.0,oS167
3,random_1,random,0,34384,6284,28100,24651,463,24188,322,1.394831852663178,1.0,2.0,oS167
4,random_2,random,0,34384,6161,28223,24768,445,24323,313,1.3882428940568476,1.0,2.0,oS167
5,random_3,random,0,34384,6253,28131,24805,446,24359,335,1.3861721427131626,1.0,2.0,oS167
6,random_4,random,0,34384,6285,28099,24838,467,24371,326,1.384330461389806,1.0,2.0,oS167
7,random_5,random,0,34384,6162,28222,24830,443,24387,334,1.3847764800644382,1.0,2.0,oS167
8,random_6,random,0,34384,6241,28143,24725,452,24273,347,1.3906572295247726,1.0,2.0,oS167
9,random_7,random,0,34384,6272,28112,24677,449,24228,318,1.3933622401426429,1.0,2.0,oS167
10,random_8,random,0,34384,6263,28121,24765,451,24314,336,1.3884110640016152,1.0,2.0,oS167
11,random_9,random,0,34384,6103,28281,24780,445,24335,325,1.3875706214689265,1.0,2.0,oS167
0,junctions,real,0,34982,1756,33226,32736,95,32641,135,1.0686094819159335,1.0,1.0,oS170
1,junctions+hops,real,0,195456,77893,117563,82218,6275,75943,2204,2.3772896446033713,1.0,6.0,oS170
2,random_0,random,0,34982,6318,28664,23966,487,23479,397,1.459651172494367,1.0,3.0,oS170
3,random_1,random,0,34982,6466,28516,23876,502,23374,402,1.4651532920087116,1.0,3.0,oS170
4,random_2,random,0,34982,6465,28517,23883,488,23395,408,1.46472386216137,1.0,3.0,oS170
5,random_3,random,0,34982,6596,28386,23807,504,23303,411,1.4693997563741756,1.0,3.0,oS170
6,random_4,random,0,34982,6401,28581,23964,488,23476,407,1.4597729928225671,1.0,3.0,oS170
7,random_5,random,0,34982,6623,28359,23772,520,23252,408,1.4715631835773177,1.0,3.0,oS170
8,random_6,random,0,34982,6277,28705,24056,492,23564,402,1.4541902228134354,1.0,3.0,oS170
9,random_7,random,0,34982,6373,28609,23903,488,23415,464,1.4634983056520101,1.0,3.0,oS170
10,random_8,random,0,34982,6336,28646,24053,476,23577,397,1.4543715960587036,1.0,3.0,oS170
11,random_9,random,0,34982,6258,28724,24061,477,23584,415,1.453888034578779,1.0,3.0,oS170
0,junctions,real,0,24824,663,24161,23817,47,23770,83,1.0422807238527103,1.0,1.0,oS172
1,junctions+hops,real,0,184636,88653,95983,68724,5834,62890,1221,2.6866305802921833,1.0,6.0,oS172
2,random_0,random,0,24824,5810,19014,16168,507,15661,171,1.5353785254824344,1.0,3.0,oS172
3,random_1,random,0,24824,5677,19147,16210,504,15706,159,1.5314003701418877,1.0,3.0,oS172
4,random_2,random,0,24824,6066,18758,16070,553,15517,165,1.544741754822651,1.0,3.0,oS172
5,random_3,random,0,24824,5815,19009,16192,515,15677,179,1.533102766798419,1.0,3.0,oS172
6,random_4,random,0,24824,5677,19147,16288,507,15781,154,1.5240667976424362,1.0,3.0,oS172
7,random_5,random,0,24824,5999,18825,16053,535,15518,188,1.5463776241201022,1.0,3.0,oS172
8,random_6,random,0,24824,5885,18939,16120,520,15600,170,1.5399503722084367,1.0,3.0,oS172
9,random_7,random,0,24824,5848,18976,16091,522,15569,168,1.542725747312162,1.0,3.0,oS172
10,random_8,random,0,24824,5875,18949,16048,521,15527,173,1.5468594217347955,1.0,3.0,oS172
11,random_9,random,0,24824,5951,18873,16126,534,15592,153,1.5393774029517548,1.0,3.0,oS172
0,junctions,real,0,29152,1182,27970,27773,59,27714,53,1.0496525402369208,1.0,1.0,oS173
1,junctions+hops,real,0,132652,23804,108848,85056,2232,82824,1767,1.5595842738901429,1.0,3.0,oS173
2,random_0,random,0,29152,2316,26836,24057,168,23889,386,1.211788668578792,1.0,2.0,oS173
3,random_1,random,0,29152,2188,26964,24083,151,23932,382,1.2104804218743512,1.0,2.0,oS173
4,random_2,random,0,29152,2229,26923,24093,162,23931,411,1.2099780019092683,1.0,2.0,oS173
5,random_3,random,0,29152,2260,26892,24084,161,23923,362,1.2104301611028068,1.0,2.0,oS173
6,random_4,random,0,29152,2249,26903,24011,164,23847,381,1.2141101994918995,1.0,2.0,oS173
7,random_5,random,0,29152,2163,26989,24242,149,24093,382,1.2025410444682783,1.0,2.0,oS173
8,random_6,random,0,29152,2204,26948,24147,155,23992,399,1.207272124901644,1.0,2.0,oS173
9,random_7,random,0,29152,2236,26916,24066,161,23905,379,1.2113354940580072,1.0,2.0,oS173
10,random_8,random,0,29152,2226,26926,24084,155,23929,401,1.2104301611028068,1.0,2.0,oS173
11,random_9,random,0,29152,2177,26975,24221,158,24063,360,1.2035836670657694,1.0,2.0,oS173
0,junctions,real,0,29394,342,29052,28594,29,28565,43,1.0279778974610059,1.0,1.0,oS174
1,junctions+hops,real,0,142860,47289,95571,64639,4472,60167,816,2.2101208248889987,1.0,5.0,oS174
2,random_0,random,0,29394,3797,25597,21252,303,20949,183,1.3831168831168832,1.0,3.0,oS174
3,random_1,random,0,29394,3934,25460,21123,303,20820,143,1.3915636983383042,1.0,3.0,oS174
4,random_2,random,0,29394,4058,25336,21145,329,20816,175,1.3901158666351383,1.0,3.0,oS174
5,random_3,random,0,29394,3772,25622,21221,299,20922,166,1.3851373639319542,1.0,3.0,oS174
6,random_4,random,0,29394,3994,25400,21195,329,20866,162,1.386836518046709,1.0,3.0,oS174
7,random_5,random,0,29394,3821,25573,21170,308,20862,170,1.3884742560226735,1.0,3.0,oS174
8,random_6,random,0,29394,3949,25445,21181,306,20875,191,1.387753175015344,1.0,3.0,oS174
9,random_7,random,0,29394,3909,25485,21189,308,20881,163,1.3872292227098966,1.0,3.0,oS174
10,random_8,random,0,29394,3819,25575,21187,305,20882,187,1.3873601736914145,1.0,3.0,oS174
11,random_9,random,0,29394,3854,25540,21259,306,20953,180,1.3826614610282704,1.0,3.0,oS174
0,junctions,real,0,31322,1296,30026,29550,98,29452,59,1.0599661590524534,1.0,1.0,oS175
1,junctions+hops,real,0,266732,154371,112361,79732,8020,71712,2675,3.345356945768324,1.0,8.0,oS175
2,random_0,random,0,31322,10381,20941,17676,796,16880,322,1.7720072414573433,1.0,4.0,oS175
3,random_1,random,0,31322,10329,20993,17713,766,16947,338,1.7683057641280415,1.0,4.0,oS175
4,random_2,random,0,31322,10226,21096,17748,750,16998,320,1.7648185711066036,1.0,4.0,oS175
5,random_3,random,0,31322,10312,21010,17754,773,16981,331,1.7642221471217754,1.0,4.0,oS175
6,random_4,random,0,31322,10356,20966,17647,769,16878,334,1.7749192497308324,1.0,4.0,oS175
7,random_5,random,0,31322,10115,21207,17835,754,17081,306,1.7562097000280348,1.0,4.0,oS175
8,random_6,random,0,31322,10086,21236,17841,765,17076,316,1.7556190796480018,1.0,4.0,oS175
9,random_7,random,0,31322,10033,21289,17974,743,17231,343,1.7426282407922555,1.0,4.0,oS175
10,random_8,random,0,31322,9958,21364,17924,747,17177,311,1.7474893996875698,1.0,4.0,oS175
11,random_9,random,0,31322,10251,21071,17774,747,17027,322,1.7622369753572633,1.0,4.0,oS175
0,junctions,real,0,21284,104,21180,20857,12,20845,17,1.0204727429639928,1.0,1.0,oS177
1,junctions+hops,real,0,148066,61948,86118,62240,4043,58197,474,2.378952442159383,1.0,5.0,oS177
2,random_0,random,0,21284,4569,16715,14393,399,13994,75,1.4787744042242756,1.0,3.0,oS177
3,random_1,random,0,21284,4703,16581,14330,419,13911,65,1.4852756454989533,1.0,3.0,oS177
4,random_2,random,0,21284,4648,16636,14380,416,13964,71,1.4801112656467317,1.0,3.0,oS177
5,random_3,random,0,21284,4501,16783,14398,401,13997,81,1.4782608695652173,1.0,3.0,oS177
6,random_4,random,0,21284,4459,16825,14601,405,14196,67,1.4577083761386207,1.0,3.0,oS177
7,random_5,random,0,21284,4600,16684,14442,425,14017,75,1.473757097354937,1.0,3.0,oS177
8,random_6,random,0,21284,4501,16783,14608,418,14190,61,1.4570098576122672,1.0,3.0,oS177
9,random_7,random,0,21284,4432,16852,14529,394,14135,67,1.4649322045564044,1.0,3.0,oS177
10,random_8,random,0,21284,4568,16716,14480,404,14076,71,1.469889502762431,1.0,3.0,oS177
11,random_9,random,0,21284,4667,16617,14377,422,13955,78,1.4804201154621965,1.0,3.0,oS177
0,junctions,real,0,21238,557,20681,20348,48,20300,41,1.0437389424022017,1.0,1.0,oS181
1,junctions+hops,real,0,133510,51624,81886,55195,4868,50327,573,2.418878521605218,1.0,6.0,oS181
2,random_0,random,0,21238,2661,18577,15358,318,15040,94,1.3828623518687329,1.0,3.0,oS181
3,random_1,random,0,21238,2630,18608,15499,304,15195,89,1.3702819536744306,1.0,3.0,oS181
4,random_2,random,0,21238,2649,18589,15432,301,15131,89,1.3762312078797305,1.0,3.0,oS181
5,random_3,random,0,21238,2511,18727,15535,290,15245,90,1.3671065336337302,1.0,3.0,oS181
6,random_4,random,0,21238,2691,18547,15413,316,15097,96,1.3779277233504186,1.0,3.0,oS181
7,random_5,random,0,21238,2716,18522,15470,311,15159,107,1.3728506787330317,1.0,3.0,oS181
8,random_6,random,0,21238,2583,18655,15548,288,15260,102,1.3659634679701569,1.0,3.0,oS181
9,random_7,random,0,21238,2742,18496,15359,316,15043,92,1.3827723159059835,1.0,3.0,oS181
10,random_8,random,0,21238,2670,18568,15503,306,15197,92,1.369928400954654,1.0,3.0,oS181
11,random_9,random,0,21238,2538,18700,15455,287,15168,85,1.374183112261404,1.0,3.0,oS181
0,junctions,real,0,26158,1680,24478,24059,90,23969,57,1.087243858847001,1.0,1.0,oS185
1,junctions+hops,real,0,151214,51854,99360,72465,4549,67916,2305,2.0867177257986613,1.0,5.0,oS185
2,random_0,random,0,26158,3407,22751,19297,289,19008,407,1.3555474944291859,1.0,3.0,oS185
3,random_1,random,0,26158,3656,22502,19222,332,18890,410,1.3608365414629071,1.0,3.0,oS185
4,random_2,random,0,26158,3454,22704,19345,304,19041,371,1.352184026880331,1.0,3.0,oS185
5,random_3,random,0,26158,3473,22685,19368,316,19052,383,1.350578273440727,1.0,3.0,oS185
6,random_4,random,0,26158,3604,22554,19242,333,18909,406,1.3594220974950628,1.0,3.0,oS185
7,random_5,random,0,26158,3476,22682,19286,315,18971,408,1.3563206471015243,1.0,3.0,oS185
8,random_6,random,0,26158,3383,22775,19416,293,19123,408,1.3472393901936548,1.0,3.0,oS185
9,random_7,random,0,26158,3614,22544,19284,323,18961,382,1.356461315079859,1.0,3.0,oS185
10,random_8,random,0,26158,3624,22534,19342,331,19011,398,1.352393754523834,1.0,3.0,oS185
11,random_9,random,0,26158,3534,22624,19332,310,19022,410,1.3530933167804675,1.0,3.0,oS185
0,junctions,real,0,19600,192,19408,19131,22,19109,22,1.0245151847786316,1.0,1.0,oS191
1,junctions+hops,real,0,84968,19882,65086,44018,2079,41939,325,1.930301240401654,1.0,4.0,oS191
2,random_0,random,0,19600,1574,18026,15206,132,15074,81,1.2889648822833093,1.0,2.0,oS191
3,random_1,random,0,19600,1660,17940,15112,140,14972,81,1.2969825304393858,1.0,2.0,oS191
4,random_2,random,0,19600,1759,17841,14982,164,14818,81,1.3082365505272995,1.0,2.0,oS191
5,random_3,random,0,19600,1647,17953,15152,153,14999,71,1.293558606124604,1.0,2.0,oS191
6,random_4,random,0,19600,1614,17986,15096,145,14951,74,1.298357180710122,1.0,2.0,oS191
7,random_5,random,0,19600,1736,17864,15086,170,14916,74,1.299217817844359,1.0,2.0,oS191
8,random_6,random,0,19600,1604,17996,15157,145,15012,90,1.293131886257175,1.0,2.0,oS191
9,random_7,random,0,19600,1858,17742,15013,169,14844,75,1.305535202824219,1.0,2.0,oS191
10,random_8,random,0,19600,1634,17966,15140,150,14990,73,1.2945838837516512,1.0,2.0,oS191
11,random_9,random,0,19600,1610,17990,15097,152,14945,82,1.2982711797045772,1.0,2.0,oS191
0,junctions,real,0,17906,1603,16303,16199,64,16135,65,1.1053768751157478,1.0,1.0,oS194
1,junctions+hops,real,0,73600,14724,58876,44891,1193,43698,782,1.6395268539350871,1.0,3.0,oS194
2,random_0,random,0,17906,1755,16151,14322,134,14188,211,1.2502443792766373,1.0,2.0,oS194
3,random_1,random,0,17906,1952,15954,14179,154,14025,187,1.2628535157627476,1.0,2.0,oS194
4,random_2,random,0,17906,1899,16007,14187,148,14039,195,1.2621413970536406,1.0,2.0,oS194
5,random_3,random,0,17906,1837,16069,14253,143,14110,182,1.2562969199466778,1.0,2.0,oS194
6,random_4,random,0,17906,1841,16065,14237,146,14091,206,1.2577087869635457,1.0,2.0,oS194
7,random_5,random,0,17906,1849,16057,14219,152,14067,185,1.2593009353681694,1.0,2.0,oS194
8,random_6,random,0,17906,1895,16011,14135,156,13979,205,1.2667845772904138,1.0,2.0,oS194
9,random_7,random,0,17906,1925,15981,14168,152,14016,217,1.2638339920948616,1.0,2.0,oS194
10,random_8,random,0,17906,1915,15991,14151,146,14005,193,1.2653522719242456,1.0,2.0,oS194
11,random_9,random,0,17906,1772,16134,14347,140,14207,203,1.248065797727748,1.0,2.0,oS194
0,junctions,real,0,494168,286,493882,480535,48,480487,15,1.0283704620891299,1.0,1.0,oS20
1,junctions+hops,real,0,3250934,981416,2269518,1484458,111165,1373293,3109,2.1899804507773206,1.0,5.0,oS20
2,random_0,random,0,494168,39173,454995,389146,2393,386753,470,1.2698781434217492,1.0,2.0,oS20
3,random_1,random,0,494168,38739,455429,389912,2366,387546,474,1.2673834095898562,1.0,2.0,oS20
4,random_2,random,0,494168,38942,455226,389681,2364,387317,502,1.2681347050536207,1.0,2.0,oS20
5,random_3,random,0,494168,39059,455109,389871,2398,387473,471,1.2675166914184435,1.0,2.0,oS20
6,random_4,random,0,494168,39087,455081,389780,2392,387388,479,1.2678126122428037,1.0,2.0,oS20
7,random_5,random,0,494168,39321,454847,389057,2357,386700,520,1.2701686385285447,1.0,2.0,oS20
8,random_6,random,0,494168,39137,455031,389340,2377,386963,495,1.2692453896337392,1.0,2.0,oS20
9,random_7,random,0,494168,39052,455116,389498,2416,387082,470,1.2687305197972776,1.0,2.0,oS20
10,random_8,random,0,494168,39113,455055,389241,2369,386872,492,1.2695682109541389,1.0,2.0,oS20
11,random_9,random,0,494168,38959,455209,389527,2382,387145,500,1.2686360637388423,1.0,2.0,oS20
0,junctions,real,0,1172,0,1172,1167,0,1167,4,1.0042844901456727,1.0,1.0,oS219
1,junctions+hops,real,0,4924,146,4778,4094,14,4080,17,1.2027357107962873,1.0,2.0,oS219
2,random_0,random,0,1172,0,1172,1088,0,1088,4,1.0772058823529411,1.0,2.0,oS219
3,random_1,random,0,1172,0,1172,1125,0,1125,3,1.0417777777777777,1.0,1.0,oS219
4,random_2,random,0,1172,16,1156,1101,3,1098,6,1.064486830154405,1.0,1.0,oS219
5,random_3,random,0,1172,15,1157,1100,3,1097,5,1.0654545454545454,1.0,1.0,oS219
6,random_4,random,0,1172,6,1166,1107,1,1106,6,1.0587172538392051,1.0,1.0,oS219
7,random_5,random,0,1172,24,1148,1078,4,1074,7,1.0871985157699444,1.0,2.0,oS219
8,random_6,random,0,1172,15,1157,1095,2,1093,9,1.0703196347031962,1.0,2.0,oS219
9,random_7,random,0,1172,16,1156,1100,3,1097,6,1.0654545454545454,1.0,2.0,oS219
10,random_8,random,0,1172,9,1163,1103,1,1102,9,1.0625566636446055,1.0,1.0,oS219
11,random_9,random,0,1172,11,1161,1108,2,1106,6,1.0577617328519855,1.0,1.0,oS219
0,junctions,real,0,438284,1047,437237,426567,123,426444,33,1.0274681351346917,1.0,1.0,oS27
1,junctions+hops,real,0,2797368,883342,1914026,1283720,106029,1177691,582,2.179110709500514,1.0,6.0,oS27
2,random_0,random,0,438284,24346,413938,347420,2973,344447,93,1.2615393471878418,1.0,2.0,oS27
3,random_1,random,0,438284,24023,414261,347488,2935,344553,102,1.2612924762869508,1.0,2.0,oS27
4,random_2,random,0,438284,24540,413744,347396,3021,344375,93,1.2616265011686951,1.0,2.0,oS27
5,random_3,random,0,438284,23787,414497,347712,2891,344821,97,1.2604799374194735,1.0,2.0,oS27
6,random_4,random,0,438284,23977,414307,347736,2921,344815,102,1.2603929417719189,1.0,2.0,oS27
7,random_5,random,0,438284,24384,413900,347159,2964,344195,89,1.262487793777491,1.0,2.0,oS27
8,random_6,random,0,438284,24156,414128,348049,2933,345116,95,1.259259472085827,1.0,2.0,oS27
9,random_7,random,0,438284,23778,414506,348122,2906,345216,89,1.2589954096552358,1.0,2.0,oS27
10,random_8,random,0,438284,24209,414075,347162,2914,344248,115,1.2624768839907594,1.0,2.0,oS27
11,random_9,random,0,438284,24029,414255,348010,2985,345025,94,1.2594005919370133,1.0,2.0,oS27
0,junctions,real,0,987006,3064,983942,936462,201,936261,75,1.0539733593034208,1.0,1.0,oS29
1,junctions+hops,real,0,6228954,2566012,3662942,2379568,257230,2122338,2579,2.6176827054322467,2.0,7.0,oS29
2,random_0,random,0,987006,122931,864075,707533,11573,695960,421,1.394996417128247,1.0,3.0,oS29
3,random_1,random,0,987006,121634,865372,708576,11356,697220,427,1.3929430293998104,1.0,3.0,oS29
4,random_2,random,0,987006,122968,864038,707084,11519,695565,393,1.3958822431281148,1.0,3.0,oS29
5,random_3,random,0,987006,122775,864231,707965,11565,696400,423,1.3941451907933302,1.0,3.0,oS29
6,random_4,random,0,987006,122576,864430,707885,11507,696378,408,1.3943027469151064,1.0,3.0,oS29
7,random_5,random,0,987006,122438,864568,706980,11439,695541,458,1.3960875838071798,1.0,3.0,oS29
8,random_6,random,0,987006,123259,863747,706924,11566,695358,418,1.3961981768903022,1.0,3.0,oS29
9,random_7,random,0,987006,123666,863340,706408,11564,694844,404,1.397218038300812,1.0,3.0,oS29
10,random_8,random,0,987006,122089,864917,707727,11435,696292,420,1.3946140248994316,1.0,3.0,oS29
11,random_9,random,0,987006,121955,865051,708111,11434,696677,413,1.3938577426420433,1.0,3.0,oS29
0,junctions,real,0,770628,2130,768498,742831,109,742722,52,1.0374203553701986,1.0,1.0,oS3
1,junctions+hops,real,0,5286328,946977,4339351,2841952,138468,2703484,692,1.8601046041593947,1.0,4.0,oS3
2,random_0,random,0,770628,12859,757769,671176,1314,669862,97,1.148175739299379,1.0,2.0,oS3
3,random_1,random,0,770628,12502,758126,671154,1260,669894,112,1.1482133757677075,1.0,2.0,oS3
4,random_2,random,0,770628,12696,757932,671087,1269,669818,98,1.1483280111222538,1.0,2.0,oS3
5,random_3,random,0,770628,12780,757848,671244,1302,669942,110,1.1480594239948514,1.0,2.0,oS3
6,random_4,random,0,770628,12670,757958,670575,1273,669302,99,1.1492047869365842,1.0,2.0,oS3
7,random_5,random,0,770628,12708,757920,671420,1294,670126,100,1.1477584820231748,1.0,2.0,oS3
8,random_6,random,0,770628,12713,757915,670898,1306,669592,100,1.148651508873182,1.0,2.0,oS3
9,random_7,random,0,770628,12647,757981,671556,1278,670278,101,1.1475260439933528,1.0,2.0,oS3
10,random_8,random,0,770628,12773,757855,670918,1279,669639,112,1.1486172676839792,1.0,2.0,oS3
11,random_9,random,0,770628,12431,758197,671394,1249,670145,109,1.1478029294274301,1.0,2.0,oS3
0,junctions,real,0,979238,2597,976641,929921,336,929585,46,1.053033537257466,1.0,1.0,oS31
1,junctions+hops,real,0,6286714,2621850,3664864,2441394,249644,2191750,1712,2.575050974975772,1.0,7.0,oS31
2,random_0,random,0,979238,131385,847853,698158,13257,684901,294,1.4026022762755708,1.0,3.0,oS31
3,random_1,random,0,979238,132433,846805,697684,13373,684311,273,1.4035551911753745,1.0,3.0,oS31
4,random_2,random,0,979238,132748,846490,697289,13363,683926,289,1.4043502765711204,1.0,3.0,oS31
5,random_3,random,0,979238,132019,847219,697459,13276,684183,285,1.404007977529862,1.0,3.0,oS31
6,random_4,random,0,979238,132072,847166,697477,13458,684019,255,1.4039717438711241,1.0,3.0,oS31
7,random_5,random,0,979238,131920,847318,697980,13350,684630,282,1.4029599701997193,1.0,3.0,oS31
8,random_6,random,0,979238,132713,846525,698197,13462,684735,303,1.402523929492679,1.0,3.0,oS31
9,random_7,random,0,979238,132938,846300,697736,13350,684386,282,1.4034505887613653,1.0,3.0,oS31
10,random_8,random,0,979238,132547,846691,697991,13381,684610,295,1.4029378602302895,1.0,3.0,oS31
11,random_9,random,0,979238,131622,847616,698689,13278,685411,260,1.4015363058528187,1.0,3.0,oS31
0,junctions,real,0,402834,1873,400961,389502,208,389294,40,1.0342283223192692,1.0,1.0,oS35
1,junctions+hops,real,0,2584866,727775,1857091,1271228,84999,1186229,1695,2.033361442636569,1.0,5.0,oS35
2,random_0,random,0,402834,22122,380712,325450,2749,322701,292,1.2377753879244124,1.0,2.0,oS35
3,random_1,random,0,402834,22106,380728,325658,2734,322924,262,1.2369848122877374,1.0,2.0,oS35
4,random_2,random,0,402834,21658,381176,325857,2694,323163,267,1.2362293889650982,1.0,2.0,oS35
5,random_3,random,0,402834,22323,380511,325316,2762,322554,265,1.2382852365085024,1.0,2.0,oS35
6,random_4,random,0,402834,21701,381133,325820,2690,323130,276,1.2363697747222393,1.0,2.0,oS35
7,random_5,random,0,402834,21783,381051,325969,2700,323269,273,1.235804631728784,1.0,2.0,oS35
8,random_6,random,0,402834,21960,380874,325388,2749,322639,253,1.2380112358169324,1.0,2.0,oS35
9,random_7,random,0,402834,22083,380751,325470,2748,322722,275,1.237699327126924,1.0,2.0,oS35
10,random_8,random,0,402834,21966,380868,325632,2716,322916,269,1.2370835790094339,1.0,2.0,oS35
11,random_9,random,0,402834,22491,380343,325459,2793,322666,278,1.237741159408712,1.0,2.0,oS35
0,junctions,real,0,402626,533,402093,392294,75,392219,23,1.0263373898147818,1.0,1.0,oS37
1,junctions+hops,real,0,2141642,677734,1463908,961227,84708,876519,309,2.2280293832778315,1.0,6.0,oS37
2,random_0,random,0,402626,23107,379519,309948,3063,306885,65,1.299011447081446,1.0,3.0,oS37
3,random_1,random,0,402626,23255,379371,309797,3103,306694,65,1.2996446059839184,1.0,3.0,oS37
4,random_2,random,0,402626,22438,380188,310512,2963,307549,63,1.296651981243881,1.0,3.0,oS37
5,random_3,random,0,402626,22631,379995,310400,3006,307394,63,1.2971198453608248,1.0,3.0,oS37
6,random_4,random,0,402626,22591,380035,310114,2988,307126,61,1.298316103110469,1.0,3.0,oS37
7,random_5,random,0,402626,22869,379757,309490,3016,306474,56,1.3009337943067627,1.0,3.0,oS37
8,random_6,random,0,402626,22758,379868,310059,3015,307044,54,1.2985464056840794,1.0,3.0,oS37
9,random_7,random,0,402626,22701,379925,309790,2995,306795,53,1.299673972691178,1.0,3.0,oS37
10,random_8,random,0,402626,22670,379956,309831,2988,306843,57,1.2995019865668702,1.0,3.0,oS37
11,random_9,random,0,402626,23038,379588,310106,3077,307029,56,1.2983495965895533,1.0,3.0,oS37
0,junctions,real,0,297566,452,297114,289037,63,288974,31,1.0295083328432,1.0,1.0,oS39
1,junctions+hops,real,0,3128030,1200950,1927080,1247361,127068,1120293,2252,2.5077182948641172,2.0,6.0,oS39
2,random_0,random,0,297566,27627,269939,236582,1769,234813,214,1.2577710899392176,1.0,2.0,oS39
3,random_1,random,0,297566,27377,270189,236785,1754,235031,216,1.2566927803703782,1.0,2.0,oS39
4,random_2,random,0,297566,27738,269828,236697,1790,234907,209,1.2571599978030985,1.0,2.0,oS39
5,random_3,random,0,297566,27800,269766,236640,1767,234873,218,1.2574628127112915,1.0,2.0,oS39
6,random_4,random,0,297566,27192,270374,237255,1750,235505,218,1.2542032833870729,1.0,2.0,oS39
7,random_5,random,0,297566,27142,270424,236908,1740,235168,191,1.2560403194489,1.0,2.0,oS39
8,random_6,random,0,297566,27539,270027,236996,1775,235221,200,1.2555739337372782,1.0,2.0,oS39
9,random_7,random,0,297566,27479,270087,236557,1791,234766,213,1.2579040146772236,1.0,2.0,oS39
10,random_8,random,0,297566,27441,270125,236535,1758,234777,226,1.258021011689602,1.0,2.0,oS39
11,random_9,random,0,297566,27255,270311,237338,1786,235552,215,1.2537646731665388,1.0,2.0,oS39
0,junctions,real,0,331168,943,330225,322802,113,322689,38,1.0259168158809424,1.0,1.0,oS46
1,junctions+hops,real,0,2195826,902703,1293123,861964,96384,765580,620,2.5474683397450475,1.0,7.0,oS46
2,random_0,random,0,331168,31426,299742,244608,3706,240902,103,1.3538723181580326,1.0,3.0,oS46
3,random_1,random,0,331168,31963,299205,244754,3818,240936,111,1.353064709871953,1.0,3.0,oS46
4,random_2,random,0,331168,31488,299680,244855,3676,241179,97,1.3525065855302119,1.0,3.0,oS46
5,random_3,random,0,331168,31488,299680,244863,3755,241108,90,1.3524623973405536,1.0,3.0,oS46
6,random_4,random,0,331168,31237,299931,245197,3664,241533,100,1.3506201136229237,1.0,3.0,oS46
7,random_5,random,0,331168,31445,299723,244239,3707,240532,102,1.3559177690704596,1.0,3.0,oS46
8,random_6,random,0,331168,31717,299451,244839,3776,241063,101,1.3525949705724987,1.0,3.0,oS46
9,random_7,random,0,331168,31817,299351,244675,3734,240941,104,1.353501583733524,1.0,3.0,oS46
10,random_8,random,0,331168,31140,300028,244884,3646,241238,102,1.3523464170791069,1.0,3.0,oS46
11,random_9,random,0,331168,31504,299664,245079,3710,241369,98,1.3512704066851913,1.0,3.0,oS46
0,junctions,real,0,675110,1187,673923,651050,145,650905,25,1.0369556869672067,1.0,1.0,oS51
1,junctions+hops,real,0,4054764,1678229,2376535,1548592,156896,1391696,3614,2.6183552543213446,1.0,6.0,oS51
2,random_0,random,0,675110,101291,573819,470105,7107,462998,606,1.4360834281703023,1.0,3.0,oS51
3,random_1,random,0,675110,101838,573272,469985,7165,462820,609,1.4364500994712597,1.0,3.0,oS51
4,random_2,random,0,675110,101208,573902,470369,7054,463315,621,1.43527740986332,1.0,3.0,oS51
5,random_3,random,0,675110,101480,573630,470471,7121,463350,621,1.4349662359635345,1.0,3.0,oS51
6,random_4,random,0,675110,101921,573189,470232,7190,463042,610,1.4356955715476616,1.0,3.0,oS51
7,random_5,random,0,675110,102002,573108,470213,7117,463096,623,1.4357535840140532,1.0,3.0,oS51
8,random_6,random,0,675110,101166,573944,471039,7104,463935,613,1.4332358891726587,1.0,3.0,oS51
9,random_7,random,0,675110,100823,574287,470014,7084,462930,594,1.4363614700838698,1.0,3.0,oS51
10,random_8,random,0,675110,101639,573471,470314,7160,463154,613,1.4354452557227724,1.0,3.0,oS51
11,random_9,random,0,675110,101857,573253,470392,7158,463234,618,1.4352072314155002,1.0,3.0,oS51
0,junctions,real,0,224918,1587,223331,219017,67,218950,66,1.0269431140048488,1.0,1.0,oS68
1,junctions+hops,real,0,1490724,462697,1028027,684704,43078,641626,1444,2.1771802121792776,1.0,5.0,oS68
2,random_0,random,0,224918,27324,197594,171502,1716,169786,221,1.3114599246656016,1.0,2.0,oS68
3,random_1,random,0,224918,27292,197626,171848,1730,170118,235,1.308819421814627,1.0,2.0,oS68
4,random_2,random,0,224918,27138,197780,171989,1730,170259,224,1.3077464256435005,1.0,2.0,oS68
5,random_3,random,0,224918,27180,197738,171667,1729,169938,210,1.3101993976710724,1.0,2.0,oS68
6,random_4,random,0,224918,27105,197813,172097,1731,170366,239,1.3069257453645329,1.0,2.0,oS68
7,random_5,random,0,224918,27459,197459,171792,1785,170007,234,1.309246065008848,1.0,2.0,oS68
8,random_6,random,0,224918,27427,197491,171932,1759,170173,219,1.308179978130889,1.0,2.0,oS68
9,random_7,random,0,224918,27015,197903,171968,1722,170246,231,1.307906122069222,1.0,2.0,oS68
10,random_8,random,0,224918,27588,197330,171569,1809,169760,215,1.3109477819419593,1.0,2.0,oS68
11,random_9,random,0,224918,27179,197739,171722,1716,170006,220,1.309779760310269,1.0,2.0,oS68
0,junctions,real,0,835372,3703,831669,799063,363,798700,169,1.0454394709803858,1.0,1.0,oS8
1,junctions+hops,real,0,5187038,1718230,3468808,2300946,179552,2121394,5724,2.2543067068935994,1.0,5.0,oS8
2,random_0,random,0,835372,82924,752448,635203,6621,628582,916,1.3151260305760522,1.0,2.0,oS8
3,random_1,random,0,835372,83433,751939,635022,6658,628364,920,1.3155008802844625,1.0,2.0,oS8
4,random_2,random,0,835372,83853,751519,635491,6626,628865,956,1.3145300248154577,1.0,2.0,oS8
5,random_3,random,0,835372,83556,751816,635364,6631,628733,966,1.3147927802015853,1.0,2.0,oS8
6,random_4,random,0,835372,83674,751698,635293,6557,628736,941,1.3149397207272864,1.0,2.0,oS8
7,random_5,random,0,835372,83825,751547,635575,6693,628882,884,1.3143562915470244,1.0,2.0,oS8
8,random_6,random,0,835372,83129,752243,635799,6622,629177,922,1.313893227262075,1.0,2.0,oS8
9,random_7,random,0,835372,82635,752737,635373,6487,628886,919,1.3147741562830022,1.0,2.0,oS8
10,random_8,random,0,835372,82974,752398,635679,6609,629070,913,1.3141412568293116,1.0,2.0,oS8
11,random_9,random,0,835372,82693,752679,635659,6523,629136,959,1.3141826041950164,1.0,2.0,oS8
0,junctions,real,0,166766,153,166613,161926,25,161901,8,1.029890196756543,1.0,1.0,oS82
1,junctions+hops,real,0,1770798,1026776,744022,513699,75951,437748,4371,3.44715095805131,2.0,8.0,oS82
2,random_0,random,0,166766,39129,127637,107045,1947,105098,433,1.5579055537390818,1.0,3.0,oS82
3,random_1,random,0,166766,39064,127702,107202,1946,105256,420,1.5556239622395105,1.0,3.0,oS82
4,random_2,random,0,166766,39378,127388,106942,1956,104986,429,1.5594060331768622,1.0,3.0,oS82
5,random_3,random,0,166766,39177,127589,107047,1963,105084,423,1.5578764467943986,1.0,3.0,oS82
6,random_4,random,0,166766,39139,127627,106757,1967,104790,449,1.562108339499986,1.0,3.0,oS82
7,random_5,random,0,166766,38805,127961,107140,1901,105239,402,1.5565241739779727,1.0,3.0,oS82
8,random_6,random,0,166766,38842,127924,107276,1946,105330,410,1.5545508781088035,1.0,3.0,oS82
9,random_7,random,0,166766,39290,127476,107020,1956,105064,420,1.5582694823397496,1.0,3.0,oS82
10,random_8,random,0,166766,39001,127765,107079,1947,105132,417,1.5574108835532645,1.0,3.0,oS82
11,random_9,random,0,166766,38942,127824,107478,1922,105556,423,1.5516291706209644,1.0,3.0,oS82
0,junctions,real,0,414614,479,414135,404323,63,404260,27,1.0254524229390858,1.0,1.0,oS83
1,junctions+hops,real,0,3196036,1623278,1572758,1032069,138406,893663,3931,3.0967270599155676,2.0,8.0,oS83
2,random_0,random,0,414614,78449,336165,276642,4969,271673,474,1.498738441740589,1.0,3.0,oS83
3,random_1,random,0,414614,78329,336285,275927,4904,271023,515,1.502622070330196,1.0,3.0,oS83
4,random_2,random,0,414614,78824,335790,275804,4985,270819,521,1.5032921930066279,1.0,3.0,oS83
5,random_3,random,0,414614,78645,335969,275946,4907,271039,510,1.502518608713299,1.0,3.0,oS83
6,random_4,random,0,414614,78628,335986,276079,4952,271127,486,1.5017947761329185,1.0,3.0,oS83
7,random_5,random,0,414614,77496,337118,276477,4855,271622,509,1.4996328808544652,1.0,3.0,oS83
8,random_6,random,0,414614,78424,336190,276085,4946,271139,529,1.5017621384718474,1.0,3.0,oS83
9,random_7,random,0,414614,78503,336111,275957,4922,271035,550,1.502458716394221,1.0,3.0,oS83
10,random_8,random,0,414614,77805,336809,276625,4907,271718,501,1.4988305467690917,1.0,3.0,oS83
11,random_9,random,0,414614,78300,336314,275914,4937,270977,518,1.5026928680675862,1.0,3.0,oS83
0,junctions,real,0,119254,167,119087,117359,21,117338,14,1.0161470360176894,1.0,1.0,oS99
1,junctions+hops,real,0,1056512,395669,660843,451412,31504,419908,2402,2.3404605991865526,1.0,5.0,oS99
2,random_0,random,0,119254,19324,99930,88554,1161,87393,293,1.346681121123834,1.0,2.0,oS99
3,random_1,random,0,119254,19294,99960,88594,1154,87440,269,1.3460730975009594,1.0,2.0,oS99
4,random_2,random,0,119254,19274,99980,88444,1149,87295,271,1.3483560218895572,1.0,2.0,oS99
5,random_3,random,0,119254,19364,99890,88663,1148,87515,275,1.3450255461692024,1.0,2.0,oS99
6,random_4,random,0,119254,19521,99733,88388,1164,87224,270,1.3492103000407296,1.0,2.0,oS99
7,random_5,random,0,119254,19345,99909,88664,1156,87508,268,1.3450103762519174,1.0,2.0,oS99
8,random_6,random,0,119254,19154,100100,88596,1143,87453,272,1.3460427107318615,1.0,2.0,oS99
9,random_7,random,0,119254,19496,99758,88369,1164,87205,259,1.349500390408401,1.0,2.0,oS99
10,random_8,random,0,119254,19221,100033,88517,1146,87371,268,1.3472440322197996,1.0,2.0,oS99
11,random_9,random,0,119254,19613,99641,88256,1163,87093,274,1.3512282451051487,1.0,2.0,oS99
0,junctions,real,0,356044,2509,353535,344987,187,344800,65,1.0320504830616806,1.0,1.0,oSH106
1,junctions+hops,real,0,1983928,786484,1197444,851640,61981,789659,12280,2.3295383025691607,1.0,6.0,oSH106
2,random_0,random,0,356044,65626,290418,244459,5296,239163,2228,1.4564569109748464,1.0,3.0,oSH106
3,random_1,random,0,356044,66161,289883,244150,5392,238758,2213,1.4583002252713495,1.0,3.0,oSH106
4,random_2,random,0,356044,65357,290687,244626,5271,239355,2190,1.4554626245779272,1.0,3.0,oSH106
5,random_3,random,0,356044,65428,290616,244591,5308,239283,2207,1.4556708954949282,1.0,3.0,oSH106
6,random_4,random,0,356044,65201,290843,244598,5294,239304,2219,1.455629236543226,1.0,3.0,oSH106
7,random_5,random,0,356044,65391,290653,244961,5311,239650,2135,1.453472185368283,1.0,3.0,oSH106
8,random_6,random,0,356044,65464,290580,244414,5274,239140,2230,1.4567250648489858,1.0,3.0,oSH106
9,random_7,random,0,356044,66342,289702,243778,5356,238422,2246,1.4605255601407838,1.0,3.0,oSH106
10,random_8,random,0,356044,66290,289754,243611,5351,238260,2251,1.4615267783474473,1.0,3.0,oSH106
11,random_9,random,0,356044,65601,290443,244656,5307,239349,2256,1.455284154077562,1.0,3.0,oSH106
0,junctions,real,0,672176,1555,670621,649773,154,649619,83,1.034478194692608,1.0,1.0,oSH11
1,junctions+hops,real,0,4976512,1339828,3636684,2408133,170155,2237978,3848,2.0665436668157446,1.0,5.0,oSH11
2,random_0,random,0,672176,25678,646498,561135,2667,558468,533,1.1978864266174807,1.0,2.0,oSH11
3,random_1,random,0,672176,25459,646717,560805,2683,558122,499,1.1985913107051471,1.0,2.0,oSH11
4,random_2,random,0,672176,25461,646715,561051,2657,558394,521,1.1980657729867694,1.0,2.0,oSH11
5,random_3,random,0,672176,25692,646484,561023,2654,558369,532,1.1981255670444884,1.0,2.0,oSH11
6,random_4,random,0,672176,25310,646866,561341,2636,558705,547,1.1974468282202797,1.0,2.0,oSH11
7,random_5,random,0,672176,25887,646289,561228,2691,558537,535,1.1976879271882372,1.0,2.0,oSH11
8,random_6,random,0,672176,25203,646973,560956,2601,558355,539,1.1982686699135048,1.0,2.0,oSH11
9,random_7,random,0,672176,25272,646904,561165,2600,558565,512,1.197822387354878,1.0,2.0,oSH11
10,random_8,random,0,672176,25825,646351,561337,2683,558654,545,1.197455361039803,1.0,2.0,oSH11
11,random_9,random,0,672176,24897,647279,561457,2580,558877,504,1.197199429341873,1.0,2.0,oSH11
0,junctions,real,0,243702,2564,241138,236448,144,236304,67,1.0306790499390988,1.0,1.0,oSH124
1,junctions+hops,real,0,1902756,922832,979924,692163,62847,629316,16122,2.7489998743070636,1.0,6.0,oSH124
2,random_0,random,0,243702,56176,187526,159104,4058,155046,2034,1.5317151045856798,1.0,3.0,oSH124
3,random_1,random,0,243702,56864,186838,158896,4070,154826,2067,1.533720169167254,1.0,3.0,oSH124
4,random_2,random,0,243702,56628,187074,158808,4085,154723,2095,1.5345700468490253,1.0,3.0,oSH124
5,random_3,random,0,243702,56786,186916,159092,4073,155019,2090,1.531830638875619,1.0,3.0,oSH124
6,random_4,random,0,243702,56866,186836,158972,4087,154885,2036,1.5329869410965453,1.0,3.0,oSH124
7,random_5,random,0,243702,55992,187710,159354,4008,155346,2110,1.529312097594036,1.0,3.0,oSH124
8,random_6,random,0,243702,56775,186927,158881,4072,154809,2094,1.5338649681207948,1.0,3.0,oSH124
9,random_7,random,0,243702,56971,186731,158778,4090,154688,2069,1.53485999319805,1.0,3.0,oSH124
10,random_8,random,0,243702,56533,187169,158956,4075,154881,2063,1.5331412466342886,1.0,3.0,oSH124
11,random_9,random,0,243702,56414,187288,159048,4048,155000,2031,1.5322544137618832,1.0,3.0,oSH124
0,junctions,real,0,67224,2150,65074,63784,135,63649,76,1.0539320205694218,1.0,1.0,oSH135
1,junctions+hops,real,0,695038,361404,333634,245465,26600,218865,13022,2.8315156947018925,1.0,8.0,oSH135
2,random_0,random,0,67224,11565,55659,46532,1058,45474,1256,1.4446832287458093,1.0,3.0,oSH135
3,random_1,random,0,67224,11958,55266,46220,1134,45086,1268,1.4544353093898745,1.0,3.0,oSH135
4,random_2,random,0,67224,11626,55598,46604,1062,45542,1283,1.442451291734615,1.0,3.0,oSH135
5,random_3,random,0,67224,11850,55374,46262,1104,45158,1294,1.4531148674938394,1.0,3.0,oSH135
6,random_4,random,0,67224,11774,55450,46472,1108,45364,1282,1.4465484592873128,1.0,3.0,oSH135
7,random_5,random,0,67224,11772,55452,46402,1075,45327,1285,1.4487306581612862,1.0,3.0,oSH135
8,random_6,random,0,67224,11959,55265,46152,1116,45036,1275,1.4565782631305253,1.0,3.0,oSH135
9,random_7,random,0,67224,12068,55156,46341,1109,45232,1305,1.4506376642713796,1.0,3.0,oSH135
10,random_8,random,0,67224,12032,55192,46217,1112,45105,1296,1.45452971850185,1.0,3.0,oSH135
11,random_9,random,0,67224,12071,55153,46410,1122,45288,1262,1.448480930833872,1.0,3.0,oSH135
0,junctions,real,0,56898,1815,55083,54369,80,54289,61,1.0465154775699388,1.0,1.0,oSH143
1,junctions+hops,real,0,505458,237422,268036,195409,15848,179561,5988,2.586666939598483,1.0,6.0,oSH143
2,random_0,random,0,56898,11957,44941,38665,939,37726,664,1.4715634294581663,1.0,3.0,oSH143
3,random_1,random,0,56898,12154,44744,38479,945,37534,680,1.4786766807869227,1.0,3.0,oSH143
4,random_2,random,0,56898,12039,44859,38567,916,37651,685,1.4753027199419193,1.0,3.0,oSH143
5,random_3,random,0,56898,11918,44980,38644,921,37723,655,1.472363109408964,1.0,3.0,oSH143
6,random_4,random,0,56898,11907,44991,38592,907,37685,700,1.4743470149253732,1.0,3.0,oSH143
7,random_5,random,0,56898,12060,44838,38557,947,37610,690,1.4756853489638717,1.0,3.0,oSH143
8,random_6,random,0,56898,12031,44867,38584,941,37643,675,1.4746527057847814,1.0,3.0,oSH143
9,random_7,random,0,56898,12188,44710,38462,922,37540,699,1.4793302480370236,1.0,3.0,oSH143
10,random_8,random,0,56898,11935,44963,38846,940,37906,656,1.4647067909179838,1.0,3.0,oSH143
11,random_9,random,0,56898,11905,44993,38615,921,37694,692,1.473468859251586,1.0,3.0,oSH143
0,junctions,real,0,55380,2410,52970,52312,64,52248,68,1.0586481113320079,1.0,1.0,oSH157
1,junctions+hops,real,0,312582,119421,193161,150445,7917,142528,5324,2.077716108876998,1.0,5.0,oSH157
2,random_0,random,0,55380,11574,43806,38393,829,37564,934,1.4424504466960122,1.0,3.0,oSH157
3,random_1,random,0,55380,11476,43904,38242,808,37434,946,1.4481460174677057,1.0,3.0,oSH157
4,random_2,random,0,55380,11686,43694,38130,816,37314,977,1.4523996852871754,1.0,3.0,oSH157
5,random_3,random,0,55380,11471,43909,38275,794,37481,908,1.4468974526453298,1.0,3.0,oSH157
6,random_4,random,0,55380,11455,43925,38084,814,37270,966,1.4541539754227497,1.0,3.0,oSH157
7,random_5,random,0,55380,11523,43857,38168,821,37347,942,1.4509536784741144,1.0,3.0,oSH157
8,random_6,random,0,55380,11678,43702,38205,829,37376,968,1.4495484884177463,1.0,3.0,oSH157
9,random_7,random,0,55380,11205,44175,38477,798,37679,908,1.4393014008368636,1.0,3.0,oSH157
10,random_8,random,0,55380,11662,43718,38156,822,37334,983,1.451410001048328,1.0,3.0,oSH157
11,random_9,random,0,55380,11548,43832,38359,841,37518,914,1.4437289814645846,1.0,3.0,oSH157
0,junctions,real,0,1408292,4961,1403331,1306025,542,1305483,120,1.0783040140885511,1.0,2.0,oSH16
1,junctions+hops,real,0,8904226,2691870,6212356,3982552,347564,3634988,2697,2.235809099291108,1.0,6.0,oSH16
2,random_0,random,0,1408292,57959,1350333,1128832,7192,1121640,417,1.2475656253543486,1.0,2.0,oSH16
3,random_1,random,0,1408292,58658,1349634,1128748,7276,1121472,440,1.2476584676119027,1.0,2.0,oSH16
4,random_2,random,0,1408292,58594,1349698,1128529,7303,1121226,434,1.2479005856296117,1.0,2.0,oSH16
5,random_3,random,0,1408292,58260,1350032,1128674,7213,1121461,434,1.2477402686692527,1.0,2.0,oSH16
6,random_4,random,0,1408292,58252,1350040,1128379,7274,1121105,423,1.2480664741190681,1.0,2.0,oSH16
7,random_5,random,0,1408292,58526,1349766,1128572,7289,1121283,468,1.2478530390617524,1.0,2.0,oSH16
8,random_6,random,0,1408292,57570,1350722,1128971,7120,1121851,424,1.2474120238695237,1.0,2.0,oSH16
9,random_7,random,0,1408292,58336,1349956,1128925,7293,1121632,440,1.2474628518280666,1.0,2.0,oSH16
10,random_8,random,0,1408292,58590,1349702,1128554,7281,1121273,442,1.2478729418353043,1.0,2.0,oSH16
11,random_9,random,0,1408292,58474,1349818,1128983,7265,1121718,432,1.2473987650832652,1.0,2.0,oSH16
0,junctions,real,0,123898,2326,121572,119054,142,118912,80,1.0406874191543334,1.0,1.0,oSH162
1,junctions+hops,real,0,925630,529367,396263,284167,33811,250356,8354,3.257345152674308,1.0,8.0,oSH162
2,random_0,random,0,123898,35606,88292,72835,2593,70242,1115,1.7010777785405369,1.0,4.0,oSH162
3,random_1,random,0,123898,35725,88173,72643,2590,70053,1110,1.7055738336797763,1.0,4.0,oSH162
4,random_2,random,0,123898,35827,88071,72398,2581,69817,1153,1.7113456172822454,1.0,4.0,oSH162
5,random_3,random,0,123898,35105,88793,72953,2575,70378,1094,1.698326319685277,1.0,4.0,oSH162
6,random_4,random,0,123898,35557,88341,72638,2549,70089,1131,1.7056912359921803,1.0,4.0,oSH162
7,random_5,random,0,123898,35503,88395,72573,2565,70008,1140,1.7072189381725986,1.0,4.0,oSH162
8,random_6,random,0,123898,35883,88015,72690,2639,70051,1172,1.704471041408722,1.0,4.0,oSH162
9,random_7,random,0,123898,35292,88606,73017,2562,70455,1099,1.6968377227221059,1.0,4.0,oSH162
10,random_8,random,0,123898,35226,88672,72856,2566,70290,1122,1.700587460195454,1.0,4.0,oSH162
11,random_9,random,0,123898,35674,88224,72830,2601,70229,1214,1.7011945626802143,1.0,4.0,oSH162
0,junctions,real,0,41118,2226,38892,38407,59,38348,67,1.0705860910771474,1.0,1.0,oSH164
1,junctions+hops,real,0,254104,114491,139613,102923,8571,94352,7515,2.4688747898914722,1.0,6.0,oSH164
2,random_0,random,0,41118,8363,32755,27242,498,26744,1238,1.5093605462154027,1.0,3.0,oSH164
3,random_1,random,0,41118,8284,32834,27467,523,26944,1168,1.4969963956748098,1.0,3.0,oSH164
4,random_2,random,0,41118,8255,32863,27304,478,26826,1276,1.5059331966012306,1.0,3.0,oSH164
5,random_3,random,0,41118,8267,32851,27211,498,26713,1255,1.511080077909669,1.0,3.0,oSH164
6,random_4,random,0,41118,8355,32763,27377,498,26879,1246,1.5019176681155715,1.0,3.0,oSH164
7,random_5,random,0,41118,8353,32765,27141,513,26628,1221,1.51497734055488,1.0,3.0,oSH164
8,random_6,random,0,41118,8409,32709,27206,517,26689,1214,1.5113577887230758,1.0,3.0,oSH164
9,random_7,random,0,41118,8244,32874,27483,508,26975,1171,1.4961248771968125,1.0,3.0,oSH164
10,random_8,random,0,41118,8260,32858,27267,517,26750,1251,1.5079766751017714,1.0,3.0,oSH164
11,random_9,random,0,41118,8197,32921,27471,491,26980,1201,1.4967784208802009,1.0,3.0,oSH164
0,junctions,real,0,37054,2111,34943,34515,72,34443,51,1.0735622193249312,1.0,1.0,oSH166
1,junctions+hops,real,0,239624,124380,115244,91483,5335,86148,3161,2.619328181192134,1.0,5.0,oSH166
2,random_0,random,0,37054,13173,23881,21089,810,20279,537,1.7570297311394565,1.0,4.0,oSH166
3,random_1,random,0,37054,13615,23439,20666,846,19820,471,1.7929933223652377,1.0,4.0,oSH166
4,random_2,random,0,37054,13421,23633,20860,832,20028,516,1.7763183125599233,1.0,4.0,oSH166
5,random_3,random,0,37054,13178,23876,20964,811,20153,475,1.7675062011066591,1.0,4.0,oSH166
6,random_4,random,0,37054,13208,23846,20997,822,20175,509,1.7647282945182645,1.0,4.0,oSH166
7,random_5,random,0,37054,13193,23861,21041,821,20220,502,1.7610379734803479,1.0,4.0,oSH166
8,random_6,random,0,37054,13357,23697,20954,825,20129,475,1.7683497184308485,1.0,4.0,oSH166
9,random_7,random,0,37054,13184,23870,20897,813,20084,520,1.7731731827535053,1.0,4.0,oSH166
10,random_8,random,0,37054,13234,23820,20957,829,20128,485,1.7680965787087846,1.0,4.0,oSH166
11,random_9,random,0,37054,13192,23862,21000,820,20180,498,1.7644761904761905,1.0,4.0,oSH166
0,junctions,real,0,622040,1555,620485,601531,165,601366,44,1.034094668437703,1.0,1.0,oSH18
1,junctions+hops,real,0,3820770,992862,2827908,1892989,122668,1770321,1975,2.018379398929418,1.0,5.0,oSH18
2,random_0,random,0,622040,29297,592743,506503,3427,503076,333,1.2281072372720399,1.0,2.0,oSH18
3,random_1,random,0,622040,28671,593369,506889,3324,503565,332,1.2271720238553214,1.0,2.0,oSH18
4,random_2,random,0,622040,29004,593036,506971,3380,503591,341,1.2269735349753734,1.0,2.0,oSH18
5,random_3,random,0,622040,29220,592820,507026,3400,503626,330,1.2268404381629345,1.0,2.0,oSH18
6,random_4,random,0,622040,29298,592742,506641,3465,503176,333,1.2277727226971367,1.0,2.0,oSH18
7,random_5,random,0,622040,29020,593020,506323,3388,502935,315,1.2285438346668036,1.0,2.0,oSH18
8,random_6,random,0,622040,29068,592972,506787,3404,503383,303,1.2274190142998933,1.0,2.0,oSH18
9,random_7,random,0,622040,29523,592517,506930,3452,503478,320,1.2270727713885545,1.0,2.0,oSH18
10,random_8,random,0,622040,29296,592744,506997,3434,503563,367,1.226910612883311,1.0,2.0,oSH18
11,random_9,random,0,622040,29448,592592,506906,3446,503460,314,1.227130868445037,1.0,2.0,oSH18
0,junctions,real,0,1275398,4423,1270975,1191501,482,1191019,125,1.0704128657886145,1.0,2.0,oSH19
1,junctions+hops,real,0,8341190,2789589,5551601,3558124,313114,3245010,3938,2.344266248168979,1.0,6.0,oSH19
2,random_0,random,0,1275398,104944,1170454,983740,8593,975147,615,1.2964787443836787,1.0,2.0,oSH19
3,random_1,random,0,1275398,104855,1170543,983987,8639,975348,622,1.2961533028383505,1.0,2.0,oSH19
4,random_2,random,0,1275398,104978,1170420,984065,8651,975414,623,1.2960505657654728,1.0,2.0,oSH19
5,random_3,random,0,1275398,104703,1170695,983350,8598,974752,588,1.296992932323181,1.0,2.0,oSH19
6,random_4,random,0,1275398,105360,1170038,983737,8699,975038,594,1.2964826981195177,1.0,2.0,oSH19
7,random_5,random,0,1275398,104585,1170813,983901,8561,975340,593,1.2962665959278423,1.0,2.0,oSH19
8,random_6,random,0,1275398,105838,1169560,983487,8691,974796,611,1.2968122608636412,1.0,2.0,oSH19
9,random_7,random,0,1275398,105359,1170039,984435,8661,975774,619,1.2955634450217637,1.0,2.0,oSH19
10,random_8,random,0,1275398,105091,1170307,983992,8625,975367,582,1.2961467166399727,1.0,2.0,oSH19
11,random_9,random,0,1275398,104976,1170422,983399,8695,974704,581,1.2969283068215445,1.0,2.0,oSH19
0,junctions,real,0,19642,2200,17442,17073,52,17021,58,1.150471504715047,1.0,1.0,oSH192
1,junctions+hops,real,0,178898,118898,60000,42965,6042,36923,4775,4.1638077504945885,1.0,11.0,oSH192
2,random_0,random,0,19642,7124,12518,10226,548,9678,541,1.920790142773323,1.0,5.0,oSH192
3,random_1,random,0,19642,7162,12480,10236,550,9686,538,1.9189136381398983,1.0,5.0,oSH192
4,random_2,random,0,19642,7126,12516,10144,543,9601,546,1.9363170347003154,1.0,5.0,oSH192
5,random_3,random,0,19642,7132,12510,10233,541,9692,541,1.9194762044366267,1.0,5.0,oSH192
6,random_4,random,0,19642,7044,12598,10348,541,9807,511,1.8981445689988403,1.0,5.0,oSH192
7,random_5,random,0,19642,7126,12516,10198,540,9658,522,1.9260639341047263,1.0,5.0,oSH192
8,random_6,random,0,19642,6956,12686,10265,523,9742,544,1.913492450073064,1.0,5.0,oSH192
9,random_7,random,0,19642,6987,12655,10280,549,9731,536,1.9107003891050585,1.0,5.0,oSH192
10,random_8,random,0,19642,6829,12813,10448,526,9922,530,1.879977029096478,1.0,5.0,oSH192
11,random_9,random,0,19642,6852,12790,10386,512,9874,503,1.8911996918929328,1.0,4.0,oSH192
0,junctions,real,0,16976,1732,15244,14895,67,14828,47,1.1397113125209801,1.0,1.0,oSH197
1,junctions+hops,real,0,219424,169218,50206,36497,6129,30368,3358,6.012110584431597,2.0,20.0,oSH197
2,random_0,random,0,16976,7750,9226,7436,656,6780,245,2.2829478214093597,1.0,7.0,oSH197
3,random_1,random,0,16976,7649,9327,7529,653,6876,228,2.2547483065480143,1.0,7.0,oSH197
4,random_2,random,0,16976,7755,9221,7435,670,6765,243,2.283254875588433,1.0,7.0,oSH197
5,random_3,random,0,16976,7740,9236,7528,675,6853,246,2.255047821466525,1.0,7.0,oSH197
6,random_4,random,0,16976,7875,9101,7400,671,6729,275,2.294054054054054,1.0,7.0,oSH197
7,random_5,random,0,16976,7799,9177,7468,676,6792,275,2.2731655061596143,1.0,7.0,oSH197
8,random_6,random,0,16976,7871,9105,7456,687,6769,269,2.276824034334764,1.0,7.0,oSH197
9,random_7,random,0,16976,7592,9384,7563,653,6910,250,2.2446119264841995,1.0,7.0,oSH197
10,random_8,random,0,16976,7727,9249,7405,657,6748,259,2.2925050641458475,1.0,7.0,oSH197
11,random_9,random,0,16976,7809,9167,7497,671,6826,244,2.26437241563292,1.0,7.0,oSH197
0,junctions,real,0,1918692,7233,1911459,1742425,769,1741656,108,1.1011618864513537,1.0,2.0,oSH2
1,junctions+hops,real,0,11359194,3995695,7363499,4588225,536697,4051528,2877,2.4757273237472006,2.0,6.0,oSH2
2,random_0,random,0,1918692,75486,1843206,1486568,9231,1477337,501,1.2906856598554524,1.0,2.0,oSH2
3,random_1,random,0,1918692,75024,1843668,1487258,9180,1478078,513,1.2900868578282987,1.0,2.0,oSH2
4,random_2,random,0,1918692,76105,1842587,1486765,9375,1477390,457,1.2905146408477466,1.0,2.0,oSH2
5,random_3,random,0,1918692,76512,1842180,1486193,9358,1476835,492,1.2910113289458367,1.0,2.0,oSH2
6,random_4,random,0,1918692,75848,1842844,1487654,9331,1478323,436,1.2897434484093748,1.0,2.0,oSH2
7,random_5,random,0,1918692,75859,1842833,1487643,9328,1478315,488,1.289752985091181,1.0,2.0,oSH2
8,random_6,random,0,1918692,75109,1843583,1487516,9246,1478270,474,1.2898631006321948,1.0,2.0,oSH2
9,random_7,random,0,1918692,76018,1842674,1486992,9318,1477674,461,1.2903176345266147,1.0,2.0,oSH2
10,random_8,random,0,1918692,76574,1842118,1485881,9402,1476479,487,1.2912824109063916,1.0,2.0,oSH2
11,random_9,random,0,1918692,75063,1843629,1487319,9213,1478106,500,1.2900339469878352,1.0,2.0,oSH2
0,junctions,real,0,14364,1280,13084,12826,64,12762,224,1.119912677374084,1.0,1.0,oSH201
1,junctions+hops,real,0,170502,123179,47323,36564,3441,33123,1545,4.663111256974073,1.0,10.0,oSH201
2,random_0,random,0,14364,7508,6856,6059,555,5504,118,2.370688232381581,1.0,9.0,oSH201
3,random_1,random,0,14364,7480,6884,6046,560,5486,143,2.3757856434005955,1.0,9.0,oSH201
4,random_2,random,0,14364,7367,6997,6157,531,5626,124,2.332954360890044,1.0,8.0,oSH201
5,random_3,random,0,14364,7412,6952,6161,556,5605,145,2.331439701347184,1.0,8.0,oSH201
6,random_4,random,0,14364,7343,7021,6093,541,5552,134,2.357459379615953,1.0,8.0,oSH201
7,random_5,random,0,14364,7419,6945,6095,537,5558,127,2.3566858080393764,1.0,9.0,oSH201
8,random_6,random,0,14364,7440,6924,6060,532,5528,141,2.37029702970297,1.0,9.0,oSH201
9,random_7,random,0,14364,7477,6887,5980,544,5436,126,2.4020066889632106,1.0,9.0,oSH201
10,random_8,random,0,14364,7434,6930,6066,547,5519,145,2.3679525222551927,1.0,9.0,oSH201
11,random_9,random,0,14364,7335,7029,6117,540,5577,128,2.348209906817067,1.0,8.0,oSH201
0,junctions,real,0,658634,2449,656185,635888,155,635733,70,1.0357704501421634,1.0,1.0,oSH21
1,junctions+hops,real,0,4196834,972780,3224054,2125550,117395,2008155,16838,1.9744696666745079,1.0,5.0,oSH21
2,random_0,random,0,658634,32693,625941,543728,2555,541173,2653,1.2113299296707176,1.0,2.0,oSH21
3,random_1,random,0,658634,32730,625904,543341,2583,540758,2742,1.212192711391189,1.0,2.0,oSH21
4,random_2,random,0,658634,32498,626136,543575,2563,541012,2624,1.2116708825829003,1.0,2.0,oSH21
5,random_3,random,0,658634,32111,626523,544228,2501,541727,2693,1.2102170413870657,1.0,2.0,oSH21
6,random_4,random,0,658634,32303,626331,544081,2540,541541,2619,1.2105440182619867,1.0,2.0,oSH21
7,random_5,random,0,658634,32630,626004,543474,2579,540895,2700,1.2118960612651204,1.0,2.0,oSH21
8,random_6,random,0,658634,32611,626023,543752,2537,541215,2663,1.2112764642704763,1.0,2.0,oSH21
9,random_7,random,0,658634,32221,626413,543531,2523,541008,2652,1.2117689699391572,1.0,2.0,oSH21
10,random_8,random,0,658634,31932,626702,544141,2485,541656,2641,1.2104105369747915,1.0,2.0,oSH21
11,random_9,random,0,658634,32787,625847,543388,2596,540792,2612,1.2120878635523789,1.0,2.0,oSH21
0,junctions,real,0,572726,1239,571487,555286,127,555159,62,1.031407238792262,1.0,1.0,oSH22
1,junctions+hops,real,0,3082122,680022,2402100,1625662,90594,1535068,1249,1.895918093675069,1.0,5.0,oSH22
2,random_0,random,0,572726,17493,555233,473455,2295,471160,237,1.2096735698218415,1.0,2.0,oSH22
3,random_1,random,0,572726,18038,554688,472472,2367,470105,253,1.2121903520208606,1.0,2.0,oSH22
4,random_2,random,0,572726,17976,554750,473086,2378,470708,263,1.2106170971028523,1.0,2.0,oSH22
5,random_3,random,0,572726,17809,554917,473425,2352,471073,267,1.2097502244283678,1.0,2.0,oSH22
6,random_4,random,0,572726,17997,554729,472535,2366,470169,237,1.2120287386119546,1.0,2.0,oSH22
7,random_5,random,0,572726,18010,554716,472706,2379,470327,244,1.211590290793855,1.0,2.0,oSH22
8,random_6,random,0,572726,17801,554925,473020,2324,470696,246,1.2107860132763941,1.0,2.0,oSH22
9,random_7,random,0,572726,17895,554831,473165,2326,470839,231,1.2104149715215622,1.0,2.0,oSH22
10,random_8,random,0,572726,17939,554787,472938,2371,470567,233,1.2109959445001248,1.0,2.0,oSH22
11,random_9,random,0,572726,17594,555132,472563,2314,470249,234,1.2119569242619503,1.0,2.0,oSH22
0,junctions,real,0,552628,867,551761,534871,123,534748,32,1.0331986591159363,1.0,1.0,oSH23
1,junctions+hops,real,0,4508468,1303643,3204825,2159643,149008,2010635,785,2.08759873738391,1.0,5.0,oSH23
2,random_0,random,0,552628,29799,522829,456732,3393,453339,102,1.2099612026308646,1.0,2.0,oSH23
3,random_1,random,0,552628,30009,522619,457153,3458,453695,103,1.2088469287087693,1.0,2.0,oSH23
4,random_2,random,0,552628,29495,523133,456974,3367,453607,93,1.2093204427385364,1.0,2.0,oSH23
5,random_3,random,0,552628,29698,522930,457016,3444,453572,104,1.209209305582299,1.0,2.0,oSH23
6,random_4,random,0,552628,29909,522719,457003,3423,453580,93,1.209243702995385,1.0,2.0,oSH23
7,random_5,random,0,552628,30545,522083,456546,3535,453011,109,1.2104541491985474,1.0,2.0,oSH23
8,random_6,random,0,552628,29478,523150,457061,3403,453658,101,1.2090902527233782,1.0,2.0,oSH23
9,random_7,random,0,552628,30197,522431,456585,3490,453095,97,1.210350756157123,1.0,2.0,oSH23
10,random_8,random,0,552628,29877,522751,456944,3438,453506,102,1.2093998389299345,1.0,2.0,oSH23
11,random_9,random,0,552628,29490,523138,457353,3408,453945,91,1.208318301180926,1.0,2.0,oSH23
0,junctions,real,0,418354,2625,415729,405612,108,405504,194,1.0314142579608099,1.0,1.0,oSH28
1,junctions+hops,real,0,2592772,618136,1974636,1359088,80956,1278132,4783,1.9077293008252594,1.0,5.0,oSH28
2,random_0,random,0,418354,13132,405222,349441,1497,347944,754,1.1972092570705783,1.0,2.0,oSH28
3,random_1,random,0,418354,13619,404735,349049,1567,347482,775,1.198553784712175,1.0,2.0,oSH28
4,random_2,random,0,418354,12882,405472,349113,1465,347648,753,1.1983340637558613,1.0,2.0,oSH28
5,random_3,random,0,418354,13432,404922,348926,1514,347412,809,1.198976287235689,1.0,2.0,oSH28
6,random_4,random,0,418354,13107,405247,349267,1452,347815,779,1.1978056902026244,1.0,2.0,oSH28
7,random_5,random,0,418354,13233,405121,349014,1504,347510,784,1.1986739786942644,1.0,2.0,oSH28
8,random_6,random,0,418354,13147,405207,349008,1503,347505,772,1.1986945857974602,1.0,2.0,oSH28
9,random_7,random,0,418354,13276,405078,348965,1539,347426,764,1.1988422907741465,1.0,2.0,oSH28
10,random_8,random,0,418354,13761,404593,348594,1596,346998,787,1.200118189068085,1.0,2.0,oSH28
11,random_9,random,0,418354,13463,404891,349340,1532,347808,768,1.19755539016431,1.0,2.0,oSH28
0,junctions,real,0,428058,2181,425877,416561,139,416422,72,1.0275997993091048,1.0,1.0,oSH33
1,junctions+hops,real,0,3013866,734720,2279146,1590094,75263,1514831,10133,1.8954011523847019,1.0,4.0,oSH33
2,random_0,random,0,428058,31558,396500,351708,2645,349063,1415,1.2170834897130574,1.0,2.0,oSH33
3,random_1,random,0,428058,31395,396663,351787,2575,349212,1475,1.2168101720643458,1.0,2.0,oSH33
4,random_2,random,0,428058,31768,396290,351789,2649,349140,1462,1.2168032542234124,1.0,2.0,oSH33
5,random_3,random,0,428058,31811,396247,351352,2643,348709,1433,1.2183166738769098,1.0,2.0,oSH33
6,random_4,random,0,428058,31536,396522,352183,2624,349559,1432,1.2154419719293663,1.0,2.0,oSH33
7,random_5,random,0,428058,31801,396257,351366,2645,348721,1482,1.2182681306671677,1.0,2.0,oSH33
8,random_6,random,0,428058,32180,395878,351289,2641,348648,1498,1.2185351662021868,1.0,2.0,oSH33
9,random_7,random,0,428058,31402,396656,352059,2618,349441,1449,1.215870067233049,1.0,2.0,oSH33
10,random_8,random,0,428058,31792,396266,351346,2634,348712,1457,1.2183374792939154,1.0,2.0,oSH33
11,random_9,random,0,428058,31881,396177,351606,2652,348954,1454,1.217436562515998,1.0,2.0,oSH33
0,junctions,real,0,379256,1217,378039,370604,98,370506,172,1.0233456735491253,1.0,1.0,oSH34
1,junctions+hops,real,0,2056526,386027,1670499,1184025,46735,1137290,932,1.7368940689596926,1.0,4.0,oSH34
2,random_0,random,0,379256,16447,362809,318251,1786,316465,158,1.1916883214821006,1.0,2.0,oSH34
3,random_1,random,0,379256,16321,362935,318501,1781,316720,169,1.190752933271795,1.0,2.0,oSH34
4,random_2,random,0,379256,16367,362889,318630,1811,316819,171,1.1902708470639927,1.0,2.0,oSH34
5,random_3,random,0,379256,16187,363069,318689,1783,316906,167,1.1900504880934077,1.0,2.0,oSH34
6,random_4,random,0,379256,16494,362762,318433,1780,316653,183,1.191007213448355,1.0,2.0,oSH34
7,random_5,random,0,379256,16055,363201,318590,1741,316849,182,1.1904202894001694,1.0,2.0,oSH34
8,random_6,random,0,379256,16123,363133,318911,1765,317146,170,1.1892220713616024,1.0,2.0,oSH34
9,random_7,random,0,379256,16869,362387,317901,1844,316057,173,1.1930003365827726,1.0,2.0,oSH34
10,random_8,random,0,379256,16578,362678,318403,1800,316603,184,1.191119430407377,1.0,2.0,oSH34
11,random_9,random,0,379256,16142,363114,318572,1781,316791,160,1.1904875506949764,1.0,2.0,oSH34
0,junctions,real,0,627662,4004,623658,601409,276,601133,114,1.0436524894040495,1.0,1.0,oSH42
1,junctions+hops,real,0,4260886,1194157,3066729,2097178,141175,1956003,13773,2.0317235828336937,1.0,5.0,oSH42
2,random_0,random,0,627662,31703,595959,512406,3406,509000,2042,1.2249310117367869,1.0,2.0,oSH42
3,random_1,random,0,627662,31843,595819,511952,3417,508535,2071,1.2260172828702691,1.0,2.0,oSH42
4,random_2,random,0,627662,31552,596110,512303,3374,508929,2008,1.225177287659842,1.0,2.0,oSH42
5,random_3,random,0,627662,31289,596373,512123,3305,508818,2036,1.225607910599602,1.0,2.0,oSH42
6,random_4,random,0,627662,31219,596443,512471,3311,509160,2007,1.2247756458414232,1.0,2.0,oSH42
7,random_5,random,0,627662,31316,596346,513059,3330,509729,2065,1.2233719708649493,1.0,2.0,oSH42
8,random_6,random,0,627662,30999,596663,512792,3311,509481,2006,1.2240089548978923,1.0,2.0,oSH42
9,random_7,random,0,627662,31468,596194,512148,3392,508756,2066,1.225548083757039,1.0,2.0,oSH42
10,random_8,random,0,627662,31529,596133,512706,3386,509320,2080,1.2242142670458314,1.0,2.0,oSH42
11,random_9,random,0,627662,31830,595832,512770,3412,509358,2070,1.2240614700548005,1.0,2.0,oSH42
0,junctions,real,0,265338,2281,263057,258990,117,258873,65,1.024510598864821,1.0,1.0,oSH49
1,junctions+hops,real,0,1952280,503708,1448572,1020809,57715,963094,9296,1.912483138373584,1.0,5.0,oSH49
2,random_0,random,0,265338,14227,251111,221014,1053,219961,1273,1.20054838155049,1.0,2.0,oSH49
3,random_1,random,0,265338,14351,250987,220795,1057,219738,1256,1.2017391698181572,1.0,2.0,oSH49
4,random_2,random,0,265338,14194,251144,221027,1055,219972,1260,1.2004777696842468,1.0,2.0,oSH49
5,random_3,random,0,265338,14434,250904,220653,1081,219572,1290,1.2025125423175755,1.0,2.0,oSH49
6,random_4,random,0,265338,14663,250675,220674,1096,219578,1289,1.202398107615759,1.0,2.0,oSH49
7,random_5,random,0,265338,14314,251024,220916,1057,219859,1278,1.2010809538467109,1.0,2.0,oSH49
8,random_6,random,0,265338,14199,251139,220738,1049,219689,1264,1.2020494885339181,1.0,2.0,oSH49
9,random_7,random,0,265338,14693,250645,220449,1092,219357,1288,1.2036253283072276,1.0,2.0,oSH49
10,random_8,random,0,265338,14293,251045,221036,1078,219958,1290,1.2004288894116795,1.0,2.0,oSH49
11,random_9,random,0,265338,14177,251161,221018,1046,219972,1296,1.2005266539376884,1.0,2.0,oSH49
0,junctions,real,0,359994,999,358995,351216,94,351122,90,1.0249931665983327,1.0,1.0,oSH52
1,junctions+hops,real,0,1742638,329060,1413578,998009,42233,955776,293,1.7461145139973688,1.0,4.0,oSH52
2,random_0,random,0,359994,12273,347721,299262,1686,297576,60,1.2029392305070474,1.0,2.0,oSH52
3,random_1,random,0,359994,12255,347739,299907,1682,298225,72,1.2003521091538376,1.0,2.0,oSH52
4,random_2,random,0,359994,12378,347616,298695,1704,296991,66,1.205222718826897,1.0,2.0,oSH52
5,random_3,random,0,359994,12053,347941,299668,1668,298000,70,1.2013094491236969,1.0,2.0,oSH52
6,random_4,random,0,359994,12474,347520,299308,1731,297577,60,1.2027543533751186,1.0,2.0,oSH52
7,random_5,random,0,359994,12545,347449,299116,1745,297371,71,1.2035263910991054,1.0,2.0,oSH52
8,random_6,random,0,359994,12139,347855,299447,1690,297757,54,1.2021960480485696,1.0,2.0,oSH52
9,random_7,random,0,359994,12292,347702,299194,1696,297498,59,1.2032126312693436,1.0,2.0,oSH52
10,random_8,random,0,359994,12101,347893,299679,1671,298008,61,1.2012653539287037,1.0,2.0,oSH52
11,random_9,random,0,359994,12454,347540,299337,1715,297622,64,1.2026378296034235,1.0,2.0,oSH52
0,junctions,real,0,357250,327,356923,349690,48,349642,17,1.0216191483885728,1.0,1.0,oSH56
1,junctions+hops,real,0,1558338,386040,1172298,812406,42662,769744,482,1.9181763797904003,1.0,5.0,oSH56
2,random_0,random,0,357250,28789,328461,275769,3027,272742,114,1.295468308620621,1.0,2.0,oSH56
3,random_1,random,0,357250,28912,328338,275684,3079,272605,115,1.2958677326214072,1.0,2.0,oSH56
4,random_2,random,0,357250,29133,328117,275780,3033,272747,143,1.2954166364493436,1.0,2.0,oSH56
5,random_3,random,0,357250,29182,328068,275263,3101,272162,119,1.297849692839212,1.0,2.0,oSH56
6,random_4,random,0,357250,28954,328296,275623,3040,272583,114,1.2961545299194914,1.0,2.0,oSH56
7,random_5,random,0,357250,28750,328500,275935,3045,272890,116,1.2946889666044539,1.0,2.0,oSH56
8,random_6,random,0,357250,29050,328200,275810,3077,272733,107,1.2952757332946594,1.0,2.0,oSH56
9,random_7,random,0,357250,28947,328303,275709,3025,272684,103,1.295750229408543,1.0,2.0,oSH56
10,random_8,random,0,357250,28959,328291,275873,3061,272812,102,1.2949799364200194,1.0,2.0,oSH56
11,random_9,random,0,357250,29127,328123,275507,3076,272431,127,1.2967002653290116,1.0,2.0,oSH56
0,junctions,real,0,1713102,7772,1705330,1567298,719,1566579,108,1.0930288943136532,1.0,2.0,oSH6
1,junctions+hops,real,0,11497178,4160898,7336280,4584537,555145,4029392,5117,2.5078166017637114,2.0,6.0,oSH6
2,random_0,random,0,1713102,60478,1652624,1353543,7405,1346138,755,1.2656428351371178,1.0,2.0,oSH6
3,random_1,random,0,1713102,61418,1651684,1353021,7518,1345503,753,1.26613112435062,1.0,2.0,oSH6
4,random_2,random,0,1713102,60579,1652523,1353646,7383,1346263,790,1.265546531367876,1.0,2.0,oSH6
5,random_3,random,0,1713102,60330,1652772,1353651,7346,1346305,776,1.265541856800608,1.0,2.0,oSH6
6,random_4,random,0,1713102,61895,1651207,1352770,7577,1345193,795,1.2663660489218418,1.0,2.0,oSH6
7,random_5,random,0,1713102,60939,1652163,1352566,7436,1345130,805,1.2665570478630988,1.0,2.0,oSH6
8,random_6,random,0,1713102,61175,1651927,1353760,7387,1346373,769,1.2654399598156247,1.0,2.0,oSH6
9,random_7,random,0,1713102,61660,1651442,1351934,7505,1344429,786,1.2671491359785314,1.0,2.0,oSH6
10,random_8,random,0,1713102,59757,1653345,1353403,7282,1346121,732,1.265773756966698,1.0,2.0,oSH6
11,random_9,random,0,1713102,60174,1652928,1353431,7398,1346033,731,1.2657475704339565,1.0,2.0,oSH6
0,junctions,real,0,350076,532,349544,342255,71,342184,18,1.0228513827409387,1.0,1.0,oSH61
1,junctions+hops,real,0,1643572,547095,1096477,803388,46022,757366,2514,2.0458010326268252,1.0,5.0,oSH61
2,random_0,random,0,350076,53684,296392,251110,4433,246677,506,1.3941141332483773,1.0,3.0,oSH61
3,random_1,random,0,350076,53935,296141,251145,4456,246689,530,1.3939198471002807,1.0,3.0,oSH61
4,random_2,random,0,350076,53355,296721,251280,4403,246877,504,1.393170964660936,1.0,3.0,oSH61
5,random_3,random,0,350076,53389,296687,251197,4389,246808,537,1.3936312933673571,1.0,3.0,oSH61
6,random_4,random,0,350076,54381,295695,250660,4508,246152,536,1.3966169313013643,1.0,3.0,oSH61
7,random_5,random,0,350076,53444,296632,251125,4432,246693,556,1.3940308611249377,1.0,3.0,oSH61
8,random_6,random,0,350076,54314,295762,250735,4460,246275,549,1.396199174427184,1.0,3.0,oSH61
9,random_7,random,0,350076,54367,295709,250803,4480,246323,564,1.3958206241552134,1.0,3.0,oSH61
10,random_8,random,0,350076,54896,295180,250167,4488,245679,557,1.3993692213601314,1.0,3.0,oSH61
11,random_9,random,0,350076,54075,296001,250983,4461,246522,513,1.394819569452911,1.0,3.0,oSH61
0,junctions,real,0,179770,1749,178021,175554,126,175428,59,1.024015402668125,1.0,1.0,oSH88
1,junctions+hops,real,0,1770234,773967,996267,729264,49145,680119,4756,2.4274254590930036,1.0,5.0,oSH88
2,random_0,random,0,179770,37447,142323,125361,2462,122899,493,1.4340185544148498,1.0,2.0,oSH88
3,random_1,random,0,179770,37386,142384,125228,2506,122722,495,1.4355415721723577,1.0,3.0,oSH88
4,random_2,random,0,179770,37207,142563,125373,2464,122909,488,1.4338812982061528,1.0,3.0,oSH88
5,random_3,random,0,179770,37192,142578,125266,2452,122814,478,1.4351060942314755,1.0,2.0,oSH88
6,random_4,random,0,179770,36989,142781,125692,2443,123249,518,1.4302421792954205,1.0,2.0,oSH88
7,random_5,random,0,179770,37255,142515,125483,2473,123010,520,1.432624339551971,1.0,2.0,oSH88
8,random_6,random,0,179770,37213,142557,125673,2492,123181,496,1.430458411910275,1.0,2.0,oSH88
9,random_7,random,0,179770,37339,142431,125451,2486,122965,482,1.432989772899379,1.0,2.0,oSH88
10,random_8,random,0,179770,37601,142169,125162,2478,122684,470,1.4362985570700373,1.0,3.0,oSH88
11,random_9,random,0,179770,37258,142512,125674,2476,123198,495,1.4304470296163088,1.0,2.0,oSH88
0,junctions,real,0,1725116,8286,1716830,1579433,709,1578724,78,1.092237530810107,1.0,2.0,oSH9
1,junctions+hops,real,0,10172982,3659264,6513718,4122076,421866,3700210,23336,2.4679268407472352,2.0,6.0,oSH9
2,random_0,random,0,1725116,145350,1579766,1291704,11503,1280201,3920,1.3355350761474765,1.0,2.0,oSH9
3,random_1,random,0,1725116,147458,1577658,1290821,11881,1278940,3901,1.3364486632925867,1.0,2.0,oSH9
4,random_2,random,0,1725116,146516,1578600,1290650,11631,1279019,3931,1.3366257312207028,1.0,2.0,oSH9
5,random_3,random,0,1725116,146040,1579076,1291863,11626,1280237,3957,1.3353707010727918,1.0,2.0,oSH9
6,random_4,random,0,1725116,146321,1578795,1291366,11649,1279717,4014,1.33588463688838,1.0,2.0,oSH9
7,random_5,random,0,1725116,146683,1578433,1290331,11652,1278679,3961,1.3369561763609492,1.0,2.0,oSH9
8,random_6,random,0,1725116,146189,1578927,1291036,11587,1279449,3955,1.3362261005889844,1.0,2.0,oSH9
9,random_7,random,0,1725116,146510,1578606,1291136,11617,1279519,4008,1.336122608307723,1.0,2.0,oSH9
10,random_8,random,0,1725116,146398,1578718,1290259,11664,1278595,3986,1.3370307821917926,1.0,2.0,oSH9
11,random_9,random,0,1725116,146168,1578948,1291429,11592,1279837,3930,1.3358194682015039,1.0,2.0,oSH9
